#format hinted
### Generated file. DO NOT EDIT.
# from https://en.wiktionary.org/wiki/Wiktionary:Frequency_lists/Japanese
# with reformating, annotation. CC BY-SA 3.0 applies.
# for debugging: 'kakasi -iutf8 -outf8 -rhepburn -Ja -Ha -f < jwikipedia-10000.corpus-source | less'

nen	年
gatsu	月
nichi	日
naru	成る
aru	有る
iu	言う
nippon	日本
tame	為
kono	この
nin	人
sono	その
made	まで
mono	もの
mata	又
kore	これ
okonau	行う
you	よう
dekiru	出来る
eki	駅
kuni	国
yori	より
daigaku	大学
genzai	現在
nochi	後
sen	線
housou	放送
gou	号
gun	軍
nai	無い
bu	部
motsu	持つ
tokoro	所
mei	名
kai	回
sekai	世界
toki	時
## sen	戦	線
jidai	時代
toukyou	東京
oku	おく
demo	でも
yobu	呼ぶ
sononochi	その後
## kai	会	回
sore	それ
ki	機
au	会う
ukeru	受ける
ooi	多い
senshu	選手
baai	場合
taisuru	対する
shikashi	しかし
tsuku	つく
shouwa	昭和
sakuhin	作品
chi	地
naka	中
shiyou	使用
tomoni	共に
gakkou	学校
go	語
kare	彼
iku	行く
###  64 アメリカ
touji	当時
bangumi	番組
kuruma	車
sha	社
kawa	川
eiga	映画
kurai	位
miru	見る
###  73 テレビ
kei	系
kenkyuu	研究
machi	町
higashi	東
sonzai	存在
katsudou	活動
hatsubai	発売
hoka	他
shusshin	出身
nendai	年代
kaisha	会社
ken	権
kaihatsu	開発
fun	分
nishi	西
tetsudou	鉄道
hou	法
kyoku	局
sarani	更に
nomi	のみ
kan	間
yama	山
shiki	式
shima	島
nao	なお
kanou	可能
###  100 ドイツ
daihyou	代表
tsukau	使う
onaji	同じ
## kyoku	曲	局
chiiki	地域
saku	作
koto	事
han	版
toru	取る
toujou	登場
###  111 チーム
yo	世
jikan	時間
okeru	於ける
chuushin	中心
taikai	大会
ooku	多く
minami	南
###  119 シリーズ
shou	賞
kita	北
kaishi	開始
###  123 フランス
ichibu	一部
hajimeru	始める
heisei	平成
shiru	知る
ko	子
###  129 ゲーム
michi	道
kaku	角
mochiiru	用いる
oyobi	および
## kan	館	間
ba	場
karada	体
seiki	世紀
ongaku	音楽
sanka	参加
happyou	発表
kiroku	記録
kakeru	掛ける
takai	高い
riyou	利用
kiwa	際
shutsujou	出場
kokusai	国際
###  148 リーグ
shozoku	所属
tsutomeru	務める
kankei	関係
kangaeru	考える
###  153 イギリス
umareru	生まれる
iru	入る
do	度
shuu	州
subete	全て
meiji	明治
nama	生
ten	点
chikara	力
yoi	良い
dake	だけ
ou	王
shiai	試合
eru	得る
yuushou	優勝
toshi	都市
fukumu	含む
###  171 アルバム
komu	込む
mondai	問題
###  174 シーズン
kaisai	開催
oosaka	大阪
ichi	位置
kantoku	監督
ue	上
shu	主
setchi	設置
## gun	郡	軍
sensou	戦争
## mono	物	もの
## kan	艦	間
chihou	地方
tai	隊
## ki	期	機
shiro	城
nite	にて
chou	長
keikaku	計画
ban	番
hitsuyou	必要
dasu	出す
ippan	一般
henkou	変更
hon	本
chuuou	中央
kansuru	関する
deru	出る
shutsuen	出演
tsukuru	作る
moto	基
jigyou	事業
iin	委員
###  207 バス
shi	市
ika	以下
shakai	社会
kyouiku	教育
jiken	事件
tokuni	特に
sotsugyou	卒業
yaku	役
tousho	当初
kekka	結果
senkyo	選挙
kikan	機関
ookii	大きい
koutou	高等
kakutoku	獲得
seifu	政府
tatakau	戦う
chuugoku	中国
saisho	最初
setsuritsu	設立
## oku	置く	おく
tane	種
kin	金
kensetsu	建設
ha	派
tsuzuku	続く
eikyou	影響
bunka	文化
ka	科
soto	外
###  238 デビュー
dai	台
jouhou	情報
soshite	そして
koukuu	航空
mura	村
seiji	政治
douyou	同様
hanbai	販売
men	面
kotonaru	異なる
tantou	担当
mottomo	最も
tera	寺
kougeki	攻撃
jinkou	人口
nagara	ながら
## oyobi	及び	および
ku	区
uma	馬
###  258 プロ
keizai	経済
tsukeru	付ける
chiku	地区
ataeru	与える
sorezore	それぞれ
nenkan	年間
mizu	水
kousei	構成
rosen	路線
## iru	射る	入る
###  269 アメリカgasshuukoku
kome	米
saiyou	採用
tomonau	伴う
shugi	主義
ageru	上げる
###  275 グループ
josei	女性
te	手
###  278 システム
rekishi	歴史
imi	意味
ippou	一方
## moto	元	基
## ken	県	権
tsuzukeru	続ける
gijutsu	技術
ataru	当たる
uchi	うち
kaigun	海軍
kou	公
hassei	発生
seizou	製造
jishin	自身
sharyou	車両
hikari	光
hanashi	話
yakyuu	野球
chousa	調査
fune	船
###  299 シングル
kachi	勝
ressha	列車
sei	正
chichi	父
katsuyaku	活躍
## shou	省	賞
shuuryou	終了
bun	文
hatsu	初
zenkoku	全国
shuuroku	収録
jinbutsu	人物
###  312 ロシア
wataru	渡る
seisaku	制作
shuunin	就任
saigo	最後
## kaku	書く	角
shita	下
###  319 エンジン
joutai	状態
katsute	かつて
katachi	形
hotondo	殆んど
hashi	橋
kettei	決定
heru	経る
soshiki	組織
###  328 イタリア
asa	朝
teikoku	帝国
seisan	生産
hatasu	果たす
kabushiki	株式
umi	海
kami	神
nendo	年度
###  337 モデル
egaku	描く
douro	道路
## sei	制	正
tsugi	次
tadashi	但し
giin	議員
kyouto	京都
bubun	部分
manga	漫画
saidai	最大
meishou	名称
ishi	石
in	員
dokuritsu	独立
kaki	書
shisetsu	施設
basho	場所
kendou	県道
hajimaru	始まる
shimesu	示す
ikou	以降
samazama	様々
ookina	大きな
###  361 クラブ
kinou	機能
## ten	天	点
###  364 サッカー
butai	部隊
tousai	搭載
hajimete	初めて
hei	兵
koukou	高校
koukai	公開
tou	党
hensei	編成
undou	運動
ryou	量
jiki	時期
###  376 センター
## seisaku	製作	制作
## han	藩	版
tsuyoi	強い
kigyou	企業
jushou	受賞
## tsuku	付く	つく
## in	院	員
mise	店
sentou	戦闘
musubu	結ぶ
mokuteki	目的
tsuujou	通常
taiou	対応
nokoru	残る
shouri	勝利
###  392 ホーム
kanri	管理
itaru	至る
dan	団
## ki	木	機
saishuu	最終
kihon	基本
kyouju	教授
###  400 ドラマ
## ageru	挙げる	上げる
kouzou	構造
sakkyoku	作曲
###  404 アニメ
sekkei	設計
jisshi	実施
gen	現
nagai	長い
###  409 メンバー
## ryou	領	量
koutsuu	交通
shitsu	室
kyoukai	協会
joshi	女子
## mono	者	もの
settei	設定
hakken	発見
keiyaku	契約
shin	信
eigo	英語
seikatsu	生活
rengou	連合
jidousha	自動車
## shiki	指揮	式
shoku	色
jibun	自分
oyobu	及ぶ
###  428 ラジオ
uta	歌
juu	重
kibo	規模
iseki	移籍
omou	思う
haishi	廃止
namae	名前
juuyou	重要
seikou	成功
hara	原
yotei	予定
tokubetsu	特別
mitomeru	認める
###  442 キャラクター
## kan	巻	間
saikou	最高
kuwaeru	加える
koko	ここ
###  447 バンド
futatabi	再び
takeshi	武
jissai	実際
soko	そこ
niru	似る
kumi	組
unten	運転
senmon	専門
shuppan	出版
naiyou	内容
## iru	煎る	入る
## ko	個	子
shougakkou	小学校
gi	義
kazu	数
owaru	終わる
rei	例
###  465 リリース
awaseru	合わせる
taisen	大戦
kagaku	科学
unkou	運行
tsui	対
hokkaidou	北海道
samurai	士
###  473 ヨーロッパ
## gun	群	軍
sukunai	少ない
shitei	指定
edo	江戸
## tokoro	ところ	所
rikugun	陸軍
nokosu	残す
## kyoukai	教会	協会
## kikan	期間	機関
kyouwa	共和
mae	前
kokka	国家
renzoku	連続
mon	門
dounyuu	導入
kinen	記念
dantai	団体
kessei	結成
tokuchou	特徴
mataha	または
hyouki	表記
taira	平
## kou	校	公
uchuu	宇宙
sougou	総合
shikyo	死去
shousetsu	小説
daitouryou	大統領
kouen	公園
###  503 タイトル
###  504 カード
keisatsu	警察
keishiki	形式
kyougi	競技
kekkon	結婚
sanshou	参照
kakawaru	係わる
natsu	夏
###  512 ローマ
kokumin	国民
chuugakkou	中学校
hyouka	評価
###  516 オリンピック
arata	新た
unei	運営
erabu	選ぶ
kanzen	完全
renpou	連邦
keiei	経営
jou	条
shidou	指導
kaigi	会議
tani	谷
kesshou	決勝
ei	英
saki	先
tenkai	展開
kansei	完成
hin	品
tasuu	多数
betsu	別
shuuhen	周辺
kodomo	子供
taishou	対象
jimu	事務
gaiyou	概要
teikyou	提供
hikou	飛行
susumu	進む
tennou	天皇
ta	田
musume	娘
###  546 マン
ichiritsu	市立
###  548 サービス
hobo	ほぼ
mukau	向かう
atsukau	扱う
intai	引退
aruiha	あるいは
motomeru	求める
doujini	同時に
otoko	男
riyuu	理由
ninki	人気
zoku	族
sakusen	作戦
en	円
katsu	勝つ
hijou	非常
atama	頭
oto	音
nozoku	除く
###  567 デザイン
gikai	議会
matsurigoto	政
ningen	人間
koushiki	公式
shika	しか
hen	編
shoki	初期
kankyou	環境
hoshi	星
nagareru	流れる
kanojo	彼女
## shi	誌	市
jiten	時点
###  581 レース
toori	通り
da	打
zentai	全体
jiyuu	自由
za	座
roudou	労働
hyouji	表示
tatoeba	例えば
wa	和
hakkou	発行
jichi	自治
saiban	裁判
houhou	方法
shien	支援
kyoudou	共同
moji	文字
sonohoka	その他
kanren	関連
atarashii	新しい
kokudou	国道
hidari	左
###  603 スポーツ
atai	値
hiroshima	広島
###  606 スペイン
eigyou	営業
hana	花
gyou	行
haha	母
sama	様
yusou	輸送
no	野
ya	屋
setsu	説
## butai	舞台	部隊
izen	以前
houmen	方面
gappei	合併
###  620 アジア
ensou	演奏
kougyou	工業
kenchiku	建築
haru	春
houjin	法人
## ken	圏	権
## machi	街	町
izure	いずれ
###  629 データ
okuru	送る
unyou	運用
kousoku	高速
ichiran	一覧
## taishou	大正	対象
kukan	区間
nouryoku	能力
shihai	支配
yuumei	有名
ginkou	銀行
shinbun	新聞
yokunen	翌年
kuukou	空港
yurai	由来
keiba	競馬
gakusha	学者
kankoku	韓国
onozukara	自ずから
sangyou	産業
seibi	整備
kuchi	口
## shi	史	市
gyousei	行政
shiken	試験
## mei	明	名
tsuma	妻
###  656 ニューヨーク
houshiki	方式
hatten	発展
waku	枠
maru	丸
###  661 ジョン
joukyou	状況
motozuku	基づく
shuyou	主要
sudeni	既に
henka	変化
jinja	神社
chigau	違う
## tou	当	党
migi	右
## ryou	両	量
## taisen	対戦	大戦
seido	制度
hiroi	広い
bangou	番号
modoru	戻る
seiritsu	成立
minato	港
## shin	新	信
tsuushin	通信
## nai	内	無い
rensai	連載
souchi	装置
kouhan	後半
goro	頃
idou	移動
kikaku	企画
denki	電気
heikin	平均
## chou	庁	長
###  691 プレー
keisai	掲載
kiyoshi	清
matsuri	祭
tami	民
nanbu	南部
###  697 サイト
kyori	距離
bunrui	分類
shurui	種類
###  701 スーパー
dansei	男性
kaze	風
fukuoka	福岡
## jou	状	条
keisei	形成
## kai	階	回
sa	差
fukin	付近
## shi	師	市
gengo	言語
gannen	元年
touroku	登録
monogatari	物語
mama	まま
koujou	工場
shuchou	主張
daijin	大臣
fukumeru	含める
shizen	自然
soubi	装備
oka	丘
mukaeru	迎える
## zoku	属	族
hiraku	開く
satsuei	撮影
keiretsu	系列
chikai	近い
igo	以後
jiko	事故
seishiki	正式
seiseki	成績
kyuu	旧
## michi	路	道
fukusuu	複数
bijutsu	美術
zasshi	雑誌
ron	論
densha	電車
shodai	初代
moukeru	設ける
obi	帯
ie	家
noberu	述べる
shashin	写真
chikyuu	地球
seiken	政権
kura	蔵
kyousou	競走
okoru	起こる
wakusei	惑星
manabu	学ぶ
kenritsu	県立
bumon	部門
chuukei	中継
oukoku	王国
matsu	末
chiba	千葉
rui	類
hyougen	表現
doubutsu	動物
shirei	司令
## tadashi	忠	但し
tetsu	鉄
seihin	製品
shiji	支持
ireru	入れる
###  768 ビル
kumu	組む
byouin	病院
## hou	方	法
noru	乗る
kantai	艦隊
keiken	経験
aki	秋
chijou	地上
###  777 メートル
ryuu	竜
sasu	指す
yokohama	横浜
fukki	復帰
kataru	語る
jouken	条件
shougun	将軍
###  785 ファン
yabureru	敗れる
nagoya	名古屋
shousuru	称する
gakusei	学生
gekijou	劇場
senshutsu	選出
koudou	行動
kokoro	心
kotoba	言葉
###  795 クラス
## dan	弾	団
## kyuu	久	旧
mori	森
shoukai	紹介
kyaku	客
hikiiru	率いる
kiru	着る
shounen	少年
ushinau	失う
kakudai	拡大
sugata	姿
o	尾
## seisaku	政策	制作
teki	敵
senyou	専用
nengoro	年頃
gunji	軍事
miya	宮
konoyou	このよう
henshuu	編集
aite	相手
oogata	大形
shinshutsu	進出
ho	保
###  820 イベント
bungaku	文学
chaku	着
###  823 ダム
hantai	反対
hogo	保護
susumeru	進める
hodo	程
onna	女
tsuika	追加
mizuumi	湖
haiyuu	俳優
###  832 メーカー
hitobito	人々
## kai	界	回
kaigyou	開業
hayashi	林
kouji	工事
tsugu	継ぐ
gendai	現代
arawasu	表す
houkou	方向
gakubu	学部
kakunin	確認
tatsu	立つ
kijutsu	記述
chokusetsu	直接
## mataha	又は	または
kojin	個人
jijitsu	事実
tougou	統合
miseru	見せる
###  852 オリジナル
haichi	配置
juurai	従来
hihan	批判
kokuritsu	国立
kaichou	会長
sumu	住む
sadameru	定める
jouyaku	条約
zouka	増加
hokubu	北部
kinnen	近年
otto	夫
yuiitsu	唯一
## gyou	業	行
musuko	息子
kimeru	決める
kouho	候補
kako	過去
eizou	映像
futsuu	普通
dou	堂
## shiro	白	城
geijutsu	芸術
sakka	作家
###  877 パリ
tochuu	途中
sou	相
shutoku	取得
ji	字
sengo	戦後
kouka	効果
jimoto	地元
tokuten	得点
###  886 トップ
###  887 ライブ
wazuka	僅か
## shou	章	賞
houkoku	報告
joyuu	女優
chousen	朝鮮
hyoujun	標準
## shuu	集	州
kichi	吉
aka	赤
## kou	項	公
###  898 ロンドン
kankou	観光
mezasu	目指す
###  901 コンピューター
###  902 ソren
utsuwa	器
hanareru	離れる
beshi	べし
koe	声
bouei	防衛
okosu	起こす
juumin	住民
kakumei	革命
###  911 インド
toku	徳
denwa	電話
choku	直
kakuchi	各地
naikaku	内閣
gentei	限定
ouza	王座
###  919 ロック
tenpo	店舗
niigata	新潟
honsen	本線
kuro	黒
otouto	弟
nami	波
hakase	博士
wan	湾
kitei	規定
## ryuu	流	竜
## kaku	核	角
gaikoku	外国
###  932 ニュース
houritsu	法律
kigen	紀元
## ta	太	田
kawaru	変わる
kyouryoku	協力
yomu	読む
shachou	社長
gyoumu	業務
atsumeru	集める
denshi	電子
hikui	低い
shimin	市民
fumei	不明
sousetsu	創設
gakkyoku	楽曲
taiwan	台湾
honmyou	本名
kuraberu	比べる
oushuu	欧州
kazoku	家族
keitou	系統
jidou	自動
tomaru	止まる
sokudo	速度
minzoku	民族
sonomama	そのまま
## chi	知	地
yoru	夜
amari	余り
###  962 オープン
arawareru	現れる
bunya	分野
seiryoku	勢力
tsutaeru	伝える
###  967 ソフト
touitsu	統一
seibutsu	生物
## dai	大	台
taiheiyou	太平洋
###  972 ヒット
koeru	超える
tochi	土地
seigyo	制御
ugoku	動く
tarou	太郎
kyuushuu	九州
## shoku	職	色
kashu	歌手
motomoto	元々
## dan	段	団
osamu	治
shijou	市場
## sou	層	相
hannou	反応
omote	表
dokuji	独自
oya	親
shirusu	記す
bi	美
hatsuden	発電
kaisei	改正
###  994 テーマ
sora	空
kumiai	組合
sansen	参戦
iki	域
shori	処理
saibou	細胞
wakeru	分ける
shouhin	商品
seinou	性能
###  1004 ポーランド
genin	原因
gensaku	原作
###  1007 ライン
anzen	安全
kaizou	改造
###  1010 カナダ
mikado	帝
tsutsu	つつ
hakaru	図る
ai	愛
akiraka	明らか
byou	秒
shigoto	仕事
haken	派遣
tokutei	特定
## shi	死	市
teigi	定義
###  1022 レコード
honbu	本部
jikken	実験
maitoshi	毎年
###  1026 タイプ
shozai	所在
kantou	関東
riron	理論
## kan	管	間
setsuzoku	接続
koube	神戸
tsuushou	通称
hakai	破壊
jitsugen	実現
## kagaku	化学	科学
shoyuu	所有
###  1038 ベース
## han	反	版
ani	兄
renmei	連盟
beikoku	米国
kyoten	拠点
shidan	師団
shujinkou	主人公
mattaku	全く
watashi	私
###  1048 トン
## kichi	基地	吉
## shitsu	質	室
tateru	建てる
seichou	成長
menseki	面積
kanagawa	神奈川
ima	今
doumei	同盟
## hatsu	発	初
## ki	記	機
kidou	軌道
gyaku	逆
tsuuzuru	通ずる
###  1062 オランダ
kouken	貢献
sonaeru	備える
shougai	障害
shougyou	商業
## kei	計	系
osu	雄
aichi	愛知
## gen	源	現
###  1071 ブランド
kounyuu	購入
chokugo	直後
koui	行為
ri	利
## matsu	松	末
yamaguchi	山口
kyou	教
touhoku	東北
asahi	朝日
hashiru	走る
###  1082 ステージ
sakusei	作成
higai	被害
kikou	機構
honsha	本社
kaigai	海外
genshi	原子
juutaku	住宅
## kawaru	代わる	変わる
tassei	達成
okinawa	沖縄
hataraku	働く
###  1094 ベスト
utau	歌う
kaikaku	改革
shuto	首都
## shu	守	主
taka	高
## shiyou	仕様	使用
hijiri	聖
tanjou	誕生
## ko	古	子
###  1104 スタジオ
nyuugaku	入学
###  1106 ビデオ
###  1107 ツアー
utsuru	移る
shitagau	従う
## kankou	刊行	観光
danshi	男子
gakuen	学園
###  1113 ポイント
fushi	節
## ban	盤	番
tatemono	建物
###  1117 コーナー
koutei	皇帝
sagyou	作業
agaru	上がる
kyoudai	兄弟
soutou	相当
###  1123 オーストラリア
shokubutsu	植物
## kami	紙	神
shuudan	集団
yoshi	慶
## toori	通	通り
touhyou	投票
hai	敗
###  1131 ネット
## tani	単位	谷
narabu	並ぶ
iji	維持
kaisan	解散
## kiru	切る	着る
keitai	形態
yuubin	郵便
kansai	関西
setsumei	説明
yasushi	康
sendai	仙台
hanshu	藩主
genshou	減少
shizuoka	静岡
mago	孫
iten	移転
koukan	交換
me	目
keiyu	経由
fukkatsu	復活
kamotsu	貨物
geneki	現役
shuen	主演
shibou	死亡
dentou	伝統
san	酸
###  1158 ポジション
ato	跡
gin	銀
###  1161 メダル
mieru	見える
youkyuu	要求
seigen	制限
zu	図
kitai	機体
kyoutsuu	共通
nougyou	農業
## kouen	公演	公園
###  1170 プレーヤー
kiji	記事
sentaku	選択
yosen	予選
###  1174 レベル
fukushima	福島
## koujou	向上	工場
###  1177 イングランド
fu	府
kenpou	憲法
youso	要素
uru	売る
bakufu	幕府
ninmu	任務
osameru	収める
hitoshi	仁
shatai	車体
###  1187 デジタル
## sono	園	その
###  1189 プロジェクト
houdou	報道
## shijou	史上	市場
## ou	追う	王
tairiku	大陸
sawa	沢
## kou	広	公
kansoku	観測
seibu	西部
yakuwari	役割
tei	定
furui	古い
jun	順
tsu	津
sugu	すぐ
miyako	都
nyuudan	入団
## ken	兼	権
## ha	葉	派
taisei	体制
## shuu	秀	州
yuusuru	有する
kijun	基準
i	井
nagano	長野
shimeru	占める
meirei	命令
bin	便
## ha	刃	派
###  1218 メーン
shushou	首相
ashi	足
hitoe	一重
kagiru	限る
###  1223 プログラム
hiku	引く
sengen	宣言
## yo	よ	世
sato	里
nakunaru	亡くなる
## ki	気	機
kunren	訓練
## kou	江	公
###  1232 レギュラー
kenzou	建造
kodai	古代
shuukyou	宗教
shippai	失敗
tegakeru	手掛ける
fukai	深い
## ta	多	田
yaru	やる
chika	地下
kakaru	係る
shuugiin	衆議院
###  1244 コース
tenmon	天文
zokusu	属す
kisai	記載
mi	身
okayama	岡山
mou	もう
###  1251 スタート
naibu	内部
tsunagaru	繋がる
toushu	投手
ryokyaku	旅客
onsen	温泉
## ko	戸	子
hantou	半島
chinamu	因む
shoujo	少女
arasou	争う
ita	板
tassuru	達する
dankai	段階
mamoru	衛
kinshi	禁止
shousai	詳細
mukeru	向ける
teishi	停止
saitama	埼玉
tairitsu	対立
###  1272 アフリカ
chiji	知事
###  1274 ワールド
taiyou	太陽
kokutetsu	国鉄
hyougo	兵庫
otozureru	訪れる
nagasaki	長崎
chuumoku	注目
ren	連
kuru	来る
rikujou	陸上
kikoku	帰国
meiyo	名誉
rentai	連隊
hakubutsu	博物
iwayuru	いわゆる
shimei	指名
###  1290 エネルギー
nasareru	為される
kiki	器機
inazuma	稲妻
## jishin	地震	自身
tsuchi	土
ao	青
kuukan	空間
tokushu	特殊
zokusuru	属する
###  1300 ホテル
yume	夢
antei	安定
ninmei	任命
shinu	死ぬ
riku	陸
## hai	杯	敗
hossoku	発足
koukei	後継
seishin	精神
kaishou	改称
ga	画
## kyou	今日	教
kindai	近代
sensui	潜水
yaburu	破る
haba	幅
isshu	一種
fuji	藤
hikakuteki	比較的
###  1320 メジャー
## iru	居る	入る
kairyou	改良
seki	席
keishou	継承
nanboku	南北
iryou	医療
okiru	起きる
sousa	操作
riji	理事
###  1330 マーク
kikai	機械
enchou	延長
kyouka	強化
shusai	主催
shoukaku	昇格
yuushuu	優秀
hotoke	仏
###  1338 カー
utsu	打つ
shibashiba	しばしば
###  1341 トラック
hizuke	日付け
tsuusan	通算
kogata	小形
senryou	占領
## sato	郷	里
touchaku	到着
## ki	紀	機
chosaku	著作
seito	生徒
fuzoku	付属
mada	まだ
## mamoru	守る	衛
## mata	また	又
toubu	東部
honrai	本来
tsuuka	通過
keizoku	継続
###  1359 ドル
tousen	当選
###  1361 コード
shikou	施行
###  1363 カリフォルニア
shiteki	指摘
renraku	連絡
kagoshima	鹿児島
makoto	真
## tsugu	次ぐ	継ぐ
kousa	交差
## naru	なる	成る
kaiin	会員
iwa	岩
jouki	上記
irai	以来
douitsu	同一
ike	池
## ryou	良	量
## han	半	版
keikou	傾向
sekinin	責任
bai	倍
haishin	配信
tosho	図書
bunri	分離
###  1385 ユダヤ
daigakuin	大学院
honnin	本人
keisan	計算
yutaka	豊
###  1390 フリー
shotou	諸島
###  1392 バージョン
###  1393 スター
## au	合う	会う
inochi	命
chiisai	小さい
fuyu	冬
## kawa	河	川
waza	技
###  1400 スタイル
###  1401 ガス
## tateru	立てる	建てる
chii	地位
ryakushou	略称
kanyuu	加入
## chousen	挑戦	朝鮮
###  1407 アナウンサー
###  1408 ホール
## kei	経	系
taisaku	対策
shiryou	資料
kamei	加盟
kishi	岸
kayou	通う
shichou	視聴
kaeru	変える
###  1417 オーストリア
###  1418 イン
hi	比
ippanni	一般に
kakuho	確保
konnan	困難
mawaru	回る
## kan	冠	間
e	絵
kiku	聞く
## san	産	酸
fueru	増える
kakaku	価格
hantei	判定
suishin	推進
###  1432 イメージ
ryouri	料理
## shou	小	賞
fukyuu	普及
toukai	東海
###  1437 ユニット
kumamoto	熊本
wakaru	分かる
sapporo	札幌
shutsuryoku	出力
jin	陣
## matsu	待つ	末
hane	羽根
meguru	巡る
###  1446 ソフトウエア
###  1447 インターネット
haji	端
###  1449 アンド
kuwawaru	加わる
se	瀬
hikaku	比較
###  1453 コーチ
minshutou	民主党
chiisana	小さな
kikkake	きっかけ
###  1457 ストーリー
handan	判断
chounan	長男
ryouiki	領域
sensha	戦車
## shuu	週	州
hirogaru	広がる
seiyuu	声優
###  1465 メディア
bunkatsu	分割
aratameru	改める
hageshii	激しい
###  1469 モード
## kyoku	極	局
taiho	逮捕
jikkou	実行
zou	像
## ikou	移行	以降
yoko	横
takara	宝
###  1477 シティ
###  1478 マイル
taikou	対抗
koushin	更新
kouki	後期
###  1482 リング
gakka	学科
###  1484 タイ
peji	頁
minshu	民主
## ken	件	権
###  1488 ピアノ
honkaku	本格
shokumin	植民
kouryuu	交流
## dou	どう	堂
kanari	かなり
shingou	信号
shinchou	身長
hani	範囲
wakai	若い
hozon	保存
tokugawa	徳川
## kyou	京	教
jiku	軸
kaisetsu	解説
###  1503 ミサイル
shigai	市街
hassha	発射
seitei	制定
kuugun	空軍
zaiseki	在籍
teian	提案
nara	奈良
koma	駒
kyakuhon	脚本
kyoukyuu	供給
kekkyoku	結局
tada	唯
gakuin	学院
katei	家庭
an	案
chichioya	父親
eisei	衛星
kokorozashi	志
###  1522 ゴール
## kaisetsu	開設	解説
zenhan	前半
tenji	展示
###  1526 ライト
choukan	長官
takashi	隆
kaiten	回転
## kitai	期待	機体
ari	有
###  1532 スウェーデン
akita	秋田
kurikaesu	繰り返す
###  1535 シーン
## ken	券	権
oujiru	応じる
kansuu	関数
shuunen	周年
tokkyuu	特急
gifu	岐阜
torishimari	取締
jousha	乗車
meimei	命名
## kaeru	換える	変える
tairyou	大量
## oku	奥	おく
sayou	作用
tettai	撤退
###  1550 ブラジル
nanoru	名乗る
###  1552 ゲスト
hanshin	阪神
yameru	止める
kubi	首
tousu	通す
###  1557 ジョージ
## tou	問う	党
densetsu	伝説
mokuhyou	目標
wakareru	分かれる
daga	だが
butsuri	物理
nazukeru	名付ける
chuushi	中止
## shuu	周	州
## shi	詩	市
torihiki	取り引き
hiru	昼
mijikai	短い
## i	伊	井
setsubi	設備
gainen	概念
touru	通る
###  1575 サイズ
###  1576 キリストkyou
sunawachi	すなわち
## keitai	携帯	形態
shikin	資金
###  1580 エリア
## sen	選	線
tsune	常
###  1583 アップ
kinmu	勤務
kaihi	回避
hikitsugu	引き継ぐ
saka	坂
oohaba	大幅
tsukasa	司
soukou	装甲
kiwameru	極める
iken	意見
## eki	液	駅
###  1594 ネットワーク
## kei	軽	系
## you	陽	よう
## juu	銃	重
bunpu	分布
###  1599 トンネル
kaikyuu	階級
shippitsu	執筆
honrui	本塁
heya	部屋
touchi	統治
kankatsu	管轄
heiki	兵器
ishikawa	石川
nasu	成す
kakuchou	拡張
hohei	歩兵
sedai	世代
###  1612 プロレス
## byou	病	秒
hama	浜
shingaku	進学
izumi	泉
chimei	地名
## kan	感	間
koushita	こうした
darou	だろう
sakushi	作詞
## kikaku	規格	企画
ittei	一定
kyuukou	急行
koshou	呼称
gakkai	学会
retsu	列
mado	窓
seisoku	生息
rinsetsu	隣接
###  1631 ラテン
koushou	交渉
tsuna	綱
nenryou	燃料
###  1635 ユーザー
kiso	基礎
saikai	再開
###  1638 フジテレビ
enshutsu	演出
heiwa	平和
## sa	さ	差
tetsugaku	哲学
buchou	部長
minasu	見做す
makeru	負ける
minkan	民間
ura	裏
houkai	崩壊
shikkou	執行
koujutsu	後述
teisha	停車
tachiba	立場
sugiru	過ぎる
zennen	前年
kotei	固定
zensaku	前作
## sou	装	相
kuchiku	駆逐
kiyou	起用
ubau	奪う
honkyo	本拠
zenjutsu	前述
## jiko	自己	事故
hatsugen	発言
tsureru	連れる
ryokou	旅行
nintei	認定
shikaku	資格
busshitsu	物質
kubetsu	区別
shisou	思想
hoken	保険
aishou	愛称
###  1674 プロデューサー
kenri	権利
shinkou	侵攻
shuuyou	収容
shuui	周囲
## sanka	酸化	参加
kaitsuu	開通
douji	同時
ke	毛
joui	上位
shouhi	消費
houshin	方針
bougyo	防御
###  1687 バック
## kan	関	間
haikei	背景
oki	沖
matomeru	纏める
shio	塩
nyuusha	入社
denryoku	電力
## rei	令	例
shokoku	諸国
keijou	形状
###  1698 カップ
kinzoku	金属
shudai	主題
###  1701 ベルリン
goukei	合計
geki	劇
###  1704 ファイル
kyousantou	共産党
buki	武器
fusoku	不足
tekiyou	適用
teiki	定期
enzuru	演ずる
tama	玉
kiken	危険
zenshin	前身
korosu	殺す
hennyuu	編入
bunsho	文書
## katei	課程	家庭
## kikai	機会	機械
taihan	大半
###  1720 スタッフ
###  1721 ショー
suzuki	鈴木
## shi	視	市
###  1724 スペシャル
## shou	症	賞
chokuzen	直前
###  1727 チャート
chiten	地点
man	満
keireki	経歴
kyuudan	球団
## chou	張	長
chiryou	治療
## shinkou	進行	侵攻
utsusu	移す
###  1736 ソビエト
gawa	側
tanaka	田中
zai	剤
sekkyoku	積極
###  1741 ウィリアム
###  1742 フォン
inu	犬
###  1744 カール
###  1745 ワシントン
## dai	代	台
kinyuu	金融
kentou	検討
koukyou	交響
seitou	政党
kaihou	解放
###  1752 ケース
###  1753 ワールドカップ
kizuku	築く
## jidou	児童	自動
geinou	芸能
## koukyou	公共	交響
kaimaku	開幕
tori	鳥
junbi	準備
## kidou	機動	軌道
soi	沿い
###  1763 ランキング
## nara	なら	奈良
hajime	初め
rokuon	録音
hiroshi	弘
###  1768 アカデミー
tounyuu	投入
masareru	優れる
shinsetsu	新設
kumiawaseru	組み合わせる
kanjiru	感じる
ishiki	意識
mare	稀
ketsugou	結合
## tama	球	玉
mazu	先ず
igaku	医学
kaifuku	回復
honkon	香港
gouryuu	合流
kokusei	国勢
umu	生む
beki	べき
gousei	合成
## ura	浦	裏
kabe	壁
jiei	自衛
ieru	言える
toukei	統計
tomo	友
kazaru	飾る
tokushima	徳島
tandoku	単独
noboru	上る
satsugai	殺害
nakamura	中村
kimaru	決まる
oeru	終える
shobun	処分
###  1802 ルール
###  1803 ミュージック
teido	程度
heihou	平方
kaigan	海岸
kaizen	改善
shuugou	集合
###  1809 カトリック
###  1810 カメラ
shuukan	週間
chuukan	中間
## ryou	料	量
yurusu	許す
koyomi	暦
shinjin	新人
fujiwara	藤原
###  1818 チャンネル
###  1819 テスト
renshuu	練習
## ken	建	権
hata	旗
saru	去る
maishuu	毎週
kagami	鏡
kamakura	鎌倉
kau	買う
saburou	三郎
miyagi	宮城
koudo	高度
jirou	次郎
kyodai	巨大
wake	わけ
###  1834 タレント
###  1835 メキシコ
chikatetsu	地下鉄
###  1837 ギリシャ
deau	出会う
###  1839 コンサート
###  1840 ソング
touzai	東西
###  1842 ルート
gamen	画面
satou	佐藤
## ishi	医師	石
houei	放映
## shichou	市長	視聴
## katsu	かつ	勝つ
kao	顔
kusuri	薬
## ou	欧	王
pekin	北京
chitai	地帯
eikoku	英国
jinmin	人民
sougo	相互
###  1857 タイム
sessuru	接する
zenin	全員
tsubasa	翼
## sei	姓	正
###  1862 セット
raku	楽
###  1864 フル
## ieru	癒える	言える
shoumetsu	消滅
## fuji	富士	藤
kokoromiru	試みる
kaijou	会場
ijuu	移住
kisei	規制
kizoku	貴族
tsuki	付
tabi	旅
## matsuri	祭り	祭
baishuu	買収
gaikou	外交
senryaku	戦略
hanasu	話す
kakkoku	各国
## sei	性	正
ran	乱
hayai	早い
hokusei	北西
## genshou	現象	減少
###  1886 ポール
ami	網
kakuritsu	確立
## zai	在	剤
nenrei	年齢
ne	根
yoshida	吉田
aomori	青森
shussou	出走
yuki	雪
gundan	軍団
rekinin	歴任
maneku	招く
shouzuru	生ずる
## kan	漢	間
teikou	抵抗
ooita	大分
###  1903 ハンガリー
ekisha	駅舎
hanran	反乱
choume	丁目
nansei	南西
shuhou	手法
gunjin	軍人
###  1910 カラー
## hi	火	比
hyoumei	表明
senkan	戦艦
dousa	動作
honyaku	翻訳
###  1916 アイルランド
###  1917 ソロ
###  1918 ジュニア
sho	署
## ari	有	有
ochiru	落ちる
atsumaru	集まる
yunyuu	輸入
###  1924 スタジアム
yuukou	有効
## zai	財	剤
kensa	検査
###  1928 アーティスト
koukoku	広告
###  1930 ブロック
taiiku	体育
toraeru	捕らえる
shoushin	昇進
## shougai	生涯	障害
jitensha	自転車
kyoka	許可
yaya	やや
teishutsu	提出
meigi	名義
youi	用意
wadai	話題
dochira	どちら
kokuou	国王
tsumi	罪
suitei	推定
kuiki	区域
###  1947 ギター
###  1948 キー
shigo	死後
## tou	塔	党
## takashi	尚	隆
toyama	富山
kokkai	国会
kusa	草
seisei	生成
yobi	予備
hanketsu	判決
tonari	隣り
kenkou	健康
## kiki	危機	器機
hitai	額
midori	緑
teika	低下
nani	何
## koeru	越える	超える
ninshiki	認識
sakura	桜
warui	悪い
makki	末期
## hiroshi	寛	弘
###  1971 サウンド
shinsa	審査
touge	峠
boueki	貿易
busou	武装
sensen	戦線
###  1977 サポート
hoyuu	保有
bonso	凡そ
ketsuekigata	血液型
###  1981 ポルトガル
###  1982 マシン
zaisei	財政
###  1984 チャンピオン
## soukou	走行	装甲
hanzai	犯罪
## wa	輪	和
hokutou	北東
fuku	福
sakana	魚
dare	誰
kyousei	強制
ouja	王者
chousei	調整
saisuru	際する
kaesu	返す
## iseki	遺跡	移籍
okureru	遅れる
###  1999 スキー
kougaku	工学
## kendou	剣道	県道
hasamu	挟む
shuuchuu	集中
ronbun	論文
yagate	やがて
kaidou	街道
kaiketsu	解決
netsu	熱
seikaku	性格
## zou	増	像
shinya	深夜
tobira	扉
kaimei	改名
ninau	担う
rinji	臨時
matsumoto	松本
shuunyuu	収入
sakai	境
giron	議論
maku	巻く
joushou	上昇
shuusen	終戦
hime	姫
###  2024 レーベル
###  2025 ニュー
chinamini	ちなみに
bunko	文庫
shuryoku	主力
## kyougi	協議	競技
shidaini	次第に
bengo	弁護
yougo	用語
jutsu	術
bunshi	分子
hikitsuzuku	引き続く
hodokosu	施す
shokuhin	食品
kyoushi	教師
tadasu	正す
yamamoto	山本
## kyou	興	教
nakama	仲間
juuryou	重量
###  2044 スイス
chuubu	中部
kyohi	拒否
hyoukou	標高
shinjuku	新宿
koumoku	項目
goukaku	合格
aimai	曖昧
yamada	山田
kurasu	暮らす
rai	来
###  2055 パーク
taberu	食べる
sugosu	過ごす
###  2058 モスクワ
ukeireru	受け入れる
###  2060 ガンダム
ryuugaku	留学
juuji	従事
warau	笑う
haka	墓
kisha	記者
kyojuu	居住
## ou	負う	王
mie	三重
kishu	機種
nageru	投げる
rashii	らしい
## ki	黄	機
osaeru	抑える
saiken	再建
## kaijou	海上	会場
###  2076 ロケット
###  2077 ドラフト
bunseki	分析
gakudan	楽団
shoumei	証明
kawasaki	川崎
## kurai	くらい	位
hitei	否定
sokumen	側面
ekimae	駅前
## wake	訳	わけ
rikai	理解
gyoukai	業界
wari	割
miyazaki	宮崎
###  2091 タウン
###  2092 アメリカン
###  2093 アイドル
jitai	事態
juubun	十分
###  2096 ダンス
chuusei	中世
yuujin	友人
engan	沿岸
hone	骨
yuuryoku	有力
###  2102 カバー
chouki	長期
kakushu	各種
## kyuushuu	吸収	九州
sachi	幸
konogoro	この頃
###  2108 エジプト
tsuneni	常に
## rui	塁	類
bakuhatsu	爆発
###  2112 ミニ
shubi	守備
shujin	主人
yamagata	山形
shinkansen	新幹線
muryou	無料
kuuki	空気
shounin	承認
sakae	栄
kumo	雲
###  2122 リスト
fushou	負傷
heisa	閉鎖
hako	箱
## shotou	初頭	諸島
## irai	依頼	以来
kokkyou	国境
yonimo	世にも
## dou	銅	堂
tankoubon	単行本
## jun	純	順
sougyou	創業
###  2134 ジェームズ
## susumu	進	進む
## kei	刑	系
tsurugi	剣
###  2138 ブレーキ
###  2139 ベトナム
mina	皆
ushi	牛
saisei	再生
souritsu	創立
hokoru	誇る
## shuukan	週刊	週間
## katei	過程	家庭
suugaku	数学
###  2148 グランプリ
jisshitsu	実質
zaidan	財団
shutsugen	出現
ibaraki	茨城
sokui	即位
## kachi	価値	勝
###  2155 インディアン
jojo	徐々
## sou	沿う	相
bakari	ばかり
###  2159 アクセス
###  2160 ボール
## tatsu	建つ	立つ
seinen	青年
genchi	現地
kasho	箇所
takahashi	高橋
shikai	司会
goei	護衛
## maku	幕	巻く
soukan	創刊
heri	縁
dendou	電動
###  2172 シート
hoshu	保守
youshi	養子
chuui	注意
watari	渡
zen	善
sanbou	参謀
saikin	最近
###  2180 バイパス
chuugaku	中学
kudaru	下る
koushi	講師
kibishii	厳しい
kasen	河川
###  2186 ドア
senshi	戦士
## i	意	井
zei	税
heishi	兵士
junyoukan	巡洋艦
###  2192 フィルム
###  2193 バー
akka	悪化
keiou	慶応
muzukashii	難しい
moshikuha	もしくは
hahaoya	母親
oou	覆う
shuuraku	集落
kabuto	甲
menkyo	免許
mamonaku	間も無く
koutai	交代
###  2205 イオン
gichou	議長
sakan	盛ん
###  2208 ジャパン
senpatsu	先発
## naka	仲	中
###  2211 コミック
## osu	押す	雄
shigeru	茂
###  2214 スペース
## tsutomeru	努める	務める
###  2216 エンターテインメント
## kou	功	公
ryoukin	料金
gakushuu	学習
suki	好き
kogaisha	子会社
## kaki	下記	書
###  2223 トルコ
## kaeru	替える	変える
kofun	古墳
hyoumen	表面
shinkei	神経
katoku	家督
gogo	午後
###  2230 サイド
###  2231 ウクライナ
hattatsu	発達
kousou	構想
###  2234 ダウン
henkan	変換
shoutotsu	衝突
zenchou	全長
taijuu	体重
ichizoku	一族
bakugeki	爆撃
masa	昌
housha	放射
nado	等
## kyoukai	境界	協会
hirou	披露
jinan	次男
tenkan	転換
kaishuu	改修
iwate	岩手
###  2250 レッド
yousei	要請
tomi	富
shimizu	清水
sakeru	避ける
otosu	落とす
## ten	典	点
###  2257 ロサンゼルス
toushi	投資
###  2259 オペラ
imouto	妹
na	な
shudan	手段
taishi	大使
## takashi	孝	隆
kaori	香
kyoukou	教皇
jouriku	上陸
## gou	合	号
shikashinagara	しかしながら
shibaraku	暫く
eda	枝
saita	最多
kibou	希望
shihon	資本
fukui	福井
kochira	こちら
###  2277 ジャンプ
shokai	初回
katou	加藤
kyouen	共演
sayuu	左右
seimei	生命
daisha	台車
chishiki	知識
oshieru	教える
nuku	抜く
yamato	大和
ame	雨
###  2289 キャリア
ana	穴
suuji	数字
## chi	血	地
kubun	区分
oni	鬼
hatchaku	発着
nantou	南東
rekidai	歴代
###  2298 トマス
## hai	廃	敗
dentetsu	電鉄
tsuka	塚
gutai	具体
baikyaku	売却
gan	癌
sake	酒
###  2306 アクション
nakaba	半ば
## kan	環	間
motarasu	もたらす
kyuushi	休止
###  2311 トーナメント
###  2312 ギリシア
## kaku	格	角
rin	燐
shinnou	親王
shimai	姉妹
bou	房
## rei	霊	例
kisoku	規則
ise	伊勢
## shou	商	賞
jinin	人員
###  2323 バラエティー
youshiki	様式
take	竹
shuusei	修正
sonoyou	そのよう
kyoutei	協定
kobayashi	小林
fukuzatsu	複雑
###  2331 スクール
###  2332 ジャン
koten	古典
mezurashii	珍しい
chikaku	近く
touban	登板
daibubun	大部分
## kougyou	興行	工業
cha	茶
## youi	容易	用意
ryousha	両者
satsujin	殺人
ikusei	育成
## seikaku	正確	性格
shinsai	震災
tochigi	栃木
nozomu	望む
###  2348 ロード
wakayama	和歌山
sanmyaku	山脈
## tsuku	就く	つく
kaishaku	解釈
hyou	票
konran	混乱
###  2355 ハウス
fukanou	不可能
###  2357 ディスク
shikan	士官
## kan	観	間
shourai	将来
## kigen	起源	紀元
gunma	群馬
nerau	狙う
itou	伊藤
###  2365 ネーム
###  2366 テニス
genzon	現存
chomei	著名
keibi	警備
gaka	画家
## kyuu	急	旧
jijou	事情
naku	泣く
## yasushi	泰	康
hojo	補助
n	ん
nashi	無し
yushutsu	輸出
###  2379 マリア
ichiban	一番
matsudaira	松平
tora	虎
shiharau	支払う
###  2384 ロボット
nagasu	流す
## ashi	脚	足
## kaeru	帰る	変える
###  2388 ターミナル
## shoku	食	色
gozen	午前
###  2391 コミュニティー
###  2392 プロダクション
###  2393 ラン
## jouki	蒸気	上記
keii	経緯
###  2396 ブラック
ikeda	池田
###  2398 ボーカル
issho	一緒
###  2400 エピソード
ensei	遠征
isan	遺産
daritsu	打率
gekkan	月刊
toko	床
teikei	提携
## shinkou	信仰	侵攻
yosan	予算
###  2409 ヘンリー
himitsu	秘密
###  2411 ロバート
nou	能
nigeru	逃げる
ikiru	生きる
shokuin	職員
## sou	そう	相
###  2417 ダイヤ
heijitsu	平日
torikumu	取り組む
###  2420 インタビュー
musen	無線
gazou	画像
moyou	模様
## senshi	戦死	戦士
###  2425 バスケットボール
shinka	進化
renketsu	連結
ittan	一旦
## kyouto	教徒	京都
haiboku	敗北
numa	沼
neko	猫
## nou	脳	能
gaibu	外部
kasaneru	重ねる
## moto	素	基
tsuini	遂に
giseki	議席
chosho	著書
uchiageru	打ち上げる
gakki	楽器
hyouron	評論
kyuujou	球場
shugo	守護
shanhai	上海
sengoku	戦国
## mura	むら	村
kotai	個体
## san	参	酸
kansen	感染
nobiru	伸びる
###  2452 コンビ
deshi	弟子
ochiiru	陥る
keiji	刑事
waseda	早稲田
## seibu	西武	西部
douki	同期
## in	印	員
ginga	銀河
kata	型
###  2462 インターチェンジ
kyounen	享年
## jun	巡	順
juushi	重視
kouchiku	構築
ikasu	生かす
tanni	単に
## hen	片	編
engeki	演劇
ruiji	類似
hanmei	判明
kaitai	解体
ridatsu	離脱
###  2475 ルイ
hanbun	半分
sasaeru	支える
gyorai	魚雷
kame	亀
tanmatsu	端末
juyo	授与
shikoku	四国
###  2483 セルビア
zaigaku	在学
tsukaeru	仕える
###  2486 ビジネス
jouto	譲渡
houi	包囲
hakobu	運ぶ
###  2490 フィールド
jigen	次元
abura	油
toritsukeru	取り付ける
###  2494 ビット
taosu	倒す
watanabe	渡辺
shisaku	試作
hoji	保持
osoreru	恐れる
###  2500 グリーン
onsei	音声
teichaku	定着
haibi	配備
meikaku	明確
###  2505 テキサス
shoubou	消防
ryouhou	両方
kizu	傷
fujin	夫人
###  2510 スケート
###  2511 イスラエル
mirai	未来
sekiyu	石油
houttsu	放つ
sangiin	参議院
sonouchi	其の内
dorei	奴隷
## yoru	因る	夜
seisho	聖書
oote	大手
## sousa	捜査	操作
gekidan	劇団
saga	佐賀
momo	桃
hiroba	広場
hashira	柱
###  2527 レイ
bunken	文献
gyousha	業者
jinrui	人類
so	祖
mahou	魔法
shutai	主体
shinri	心理
## kikan	帰還	機関
jitsugyou	実業
ryoudo	領土
yanagi	柳
kashi	歌詞
takeda	武田
###  2541 パイロット
## kou	こう	公
genba	現場
###  2544 メモリー
kounin	公認
kouryo	考慮
yu	湯
seishitsu	性質
touyou	東洋
## shiji	指示	支持
kakageru	掲げる
kanja	患者
###  2553 パワー
toriireru	取り入れる
## koshou	故障	呼称
saido	再度
chuukajinminkyouwakoku	中華人民共和国
###  2558 ファッション
koso	こそ
###  2560 オフ
## sanka	傘下	参加
zemeru	攻める
shougou	称号
###  2564 スポンサー
kure	呉
takamaru	高まる
## taishou	大賞	対象
kanryou	完了
ben	弁
wakatsu	分かつ
###  2571 ウィーン
hori	堀
boku	僕
## ji	自	字
## jinkou	人工	人口
mitasu	満たす
senro	線路
houmon	訪問
shoujiru	生じる
kouritsu	効率
## shou	将	賞
shinrai	信頼
yousu	様子
koi	恋
## mi	実	身
hakki	発揮
kougai	郊外
boppatsu	勃発
setai	世帯
tsuihou	追放
kawari	代わり
tamago	卵
tokui	得意
###  2594 プロデュース
kokubou	国防
bukkyou	仏教
sokutei	測定
## kishi	騎士	岸
gaku	岳
ichirou	一郎
kashin	家臣
chiri	地理
shokugyou	職業
## fuku	服	福
###  2605 ミュージシャン
## takashi	貴	隆
keta	桁
douga	動画
bunki	分岐
genjitsu	現実
###  2611 ジャズ
dono	どの
bunretsu	分裂
ansatsu	暗殺
tanki	短期
togeru	遂げる
goui	合意
souzoku	相続
dageki	打撃
## haru	張る	春
shigen	資源
uttaeru	訴える
###  2623 インチ
inoue	井上
###  2625 シカゴ
###  2626 クラシック
koufuku	降伏
###  2628 ウェブ
kabu	下部
###  2630 アニメーション
###  2631 ベルギー
###  2632 ランド
###  2633 ジャック
###  2634 パソコン
kudasu	下す
tanjun	単純
###  2637 デンマーク
meizuru	命ずる
tsugitsugi	次々
## chou	帳	長
###  2641 ハイ
toriatsukau	取り扱う
ryuukou	流行
## jun	旬	順
senji	戦時
###  2646 ジャンル
## jinin	辞任	人員
saibai	栽培
shikichi	敷地
kyokuchou	局長
suiso	水素
## kyouryoku	強力	協力
shutsuba	出馬
chokutsuu	直通
daeru	抱える
itchi	一致
## juu	住	重
soshou	訴訟
yokujitsu	翌日
yamanashi	山梨
nyuuryoku	入力
enjo	援助
nando	何度
fukushi	福祉
iriguchi	入り口
###  2666 ローカル
tasukeru	助ける
naganen	長年
shitagatte	従って
tottori	鳥取
ouji	王子
shokini	初期に
annai	案内
## i	医	井
fukkou	復興
###  2676 ソウル
insatsu	印刷
renpa	連覇
###  2679 モーター
bamen	場面
kakuu	架空
###  2682 メール
shouten	商店
sochi	措置
shoushou	少将
jiin	寺院
idenshi	遺伝子
###  2688 パーソナリティ
## kikou	気候	機構
katsuyou	活用
###  2691 スコットランド
habahiroi	幅広い
jisha	自社
toride	砦
senkou	先行
kenryoku	権力
danjo	男女
daku	抱く
kaneru	兼ねる
kari	仮
## fushou	不詳	負傷
tobu	飛ぶ
###  2703 コスト
aku	悪
hisashi	寿
shisei	姿勢
taikei	体系
## fuku	吹く	福
soushou	総称
utsukushii	美しい
seidou	聖堂
###  2712 リンク
yosou	予想
kouseki	功績
shinwa	神話
tayou	多様
oufuku	往復
ryoushin	両親
buhin	部品
###  2720 ライター
kokugo	国語
## saku	策	作
shoseki	書籍
kyojin	巨人
tsuru	鶴
## taka	多寡	高
## juuji	十字	従事
sodatsu	育つ
yuudou	誘導
hiyou	費用
jitaku	自宅
###  2732 オープニング
###  2733 アマチュア
###  2734 クイズ
henkyoku	編曲
chokusen	直線
###  2737 コムーネ
kioku	記憶
###  2739 エンディング
kankyaku	観客
kara	殻
## toushu	当主	投手
sakusha	作者
boushi	防止
kinkou	近郊
###  2746 ヘッド
soushin	送信
seiri	整理
suke	介
kigou	記号
kanji	漢字
## shi	し	市
###  2753 コピー
takamatsu	高松
kireru	切れる
ouchou	王朝
kudou	駆動
###  2758 ブルー
## kan	韓	間
shouken	証券
shamei	社名
kyuusoku	急速
kagiri	限り
###  2764 ドーム
nitchuu	日中
###  2766 ライダー
soutoku	総督
watasu	渡す
## tei	亭	定
ondo	温度
masu	増す
###  2772 アイテム
mine	峰
megumi	恵
dattai	脱退
###  2776 フィンランド
tamotsu	保つ
seisu	制す
oohashi	大橋
## moshikuha	若しくは	もしくは
betsumei	別名
###  2782 イスラム
###  2783 ボタン
konomu	好む
heian	平安
mitsubishi	三菱
gensoku	原則
shouchou	象徴
bansen	番線
hanshoku	繁殖
shuugeki	襲撃
###  2792 ボード
kanyo	関与
gu	具
futan	負担
###  2796 チャールズ
## senkou	専攻	先行
shinsei	申請
###  2799 ブーム
michibiku	導く
medatsu	目立つ
suji	筋
shikyou	司教
kuma	熊
zousen	造船
###  2806 ライセンス
###  2807 タッグ
rieki	利益
## shiji	師事	支持
## hiroshi	博	弘
kaiga	絵画
ryuutsuu	流通
yomiuri	読売
shousuu	少数
hoshou	保障
## hiroshi	洋	弘
taizai	滞在
## hi	碑	比
## sou	荘	相
umeru	埋める
## ten	転	点
###  2822 モンゴル
jisseki	実績
kouhyou	公表
tabitabi	度々
ryodan	旅団
izon	依存
shinki	新規
kintetsu	近鉄
senbatsu	選抜
nakayama	中山
inai	以内
jouge	上下
###  2834 ボクシング
chuuki	中期
oda	織田
###  2837 オスマン
###  2838 リーダー
kouso	酵素
shun	俊
saitei	最低
issai	一切
shuppatsu	出発
daitai	大隊
teishajou	停車場
kousha	後者
###  2847 トーク
## ya	矢	屋
###  2849 マイケル
garasu	硝子
ito	意図
###  2852 プロイセン
daimyou	大名
kokudo	国土
###  2855 フリードリヒ
###  2856 ロング
###  2857 カット
###  2858 ウルトラ
aitsugu	相次ぐ
bakudan	爆弾
ane	姉
shougaku	小学
ryuuiki	流域
kishou	気象
raireki	来歴
shiroi	白い
kassei	活性
juni	順位
tekkyo	撤去
shuuha	周波
takarazuka	宝塚
yado	宿
dairi	代理
kanbu	幹部
yuusen	優先
tsumu	積む
ueno	上野
nyuushu	入手
## kabu	株	下部
attou	圧倒
###  2881 ジム
roku	禄
yuzuru	譲る
## tei	艇	定
###  2885 キング
akai	赤い
## kyou	卿	教
shibuya	渋谷
## gaku	学	岳
zokuhen	続編
fukugou	複合
## kishu	騎手	機種
###  2893 リード
ooaza	大字
goudou	合同
hontai	本体
tazusawaru	携わる
katsura	桂
## dou	動	堂
seiyou	西洋
## gendai	原題	現代
###  2902 ミッション
## ri	理	利
## tsukuru	造る	作る
zaseki	座席
imin	移民
kazoeru	数える
kouhou	後方
kakutei	確定
###  2910 ミス
byousha	描写
fusegu	防ぐ
## osamu	修	治
sofu	祖父
kanshin	関心
taru	足る
taiken	体験
kotaeru	答える
teiketsu	締結
###  2920 ノルウェー
teru	輝
## kai	下位	回
ude	腕
zengo	前後
kitachousen	北朝鮮
## i	異	井
chuujou	中将
sukoshi	少し
joou	女王
kizon	既存
joubu	上部
###  2932 イラスト
ra	羅
###  2934 コメント
###  2935 イラン
###  2936 バレーボール
###  2937 ディーゼル
kongo	今後
## ka	可	科
bouken	冒険
jitsuyou	実用
###  2942 セント
kouryaku	攻略
kouchi	高知
###  2945 ベル
jushin	受信
gei	芸
ihan	違反
komon	顧問
soujuu	操縦
yane	屋根
## kaishou	解消	改称
tsutawaru	伝わる
## taishou	大将	対象
isami	勇
## shinkou	振興	侵攻
guntai	軍隊
tenzuru	転ずる
semaru	迫る
kakou	加工
hatsumei	発明
teishou	提唱
## kyou	享	教
###  2964 パン
shuzai	取材
uwamawaru	上回る
sankou	参考
###  2968 コレクション
houjou	北条
## ten	展	点
shihou	司法
kougi	抗議
tokkyo	特許
kuubo	空母
jimintou	自民党
byouki	病気
souhou	双方
## gen	玄	現
###  2979 ナショナル
zettai	絶対
sendan	船団
kaikyou	海峡
kinkyuu	緊急
keirin	競輪
juyou	需要
ashikaga	足利
## daitai	代替	大隊
jissou	実装
ikaru	怒る
kisaki	后
toutatsu	到達
ehime	愛媛
songai	損害
ichiren	一連
###  2995 アルゼンチン
###  2996 ドライバー
## shuuryou	修了	終了
reigai	例外
## sei	晴	正
dokutoku	独特
shumi	趣味
heikou	並行
kakomu	囲む
kaisoku	快速
###  3005 ナイト
senryoku	戦力
noriireru	乗り入れる
mitsudo	密度
kage	影
## tou	棟	党
## sentou	先頭	戦闘
###  3012 ケーブル
saihen	再編
mainichi	毎日
nogareru	逃れる
soutai	相対
###  3017 アプリケーション
osou	襲う
doujitsu	同日
jouei	上映
## kyousou	競争	競走
shison	子孫
shuudouin	修道院
bunkai	分解
## ho	補	保
kukaku	区画
kitou	気筒
shiba	芝
kun	君
nini	任意
renshou	連勝
hakkutsu	発掘
shintai	身体
###  3034 フィリピン
###  3035 クリア
###  3036 レコーディング
ikkan	一環
kagawa	香川
doyou	土曜
hikiokosu	引き起こす
jakkan	若干
kakusu	隠す
furu	振る
yuu	優
suisen	推薦
sentan	先端
haisha	廃車
###  3048 スピード
yosu	よす
kaisatsu	改札
heiya	平野
itaku	委託
modosu	戻す
zaijuu	在住
## sei	斉	正
## nin	任	人
omoi	重い
tanpaku	蛋白
doko	どこ
hatsuon	発音
mune	旨
## yoru	寄る	夜
hidekichi	秀吉
rikkouho	立候補
kantan	簡単
tsuyu	露
## kouritsu	公立	効率
###  3068 ボディ
shibu	支部
honoo	炎
## kou	工	公
jisatsu	自殺
###  3073 ゴルフ
tetsuzuki	手続き
shikei	死刑
kaminari	雷
shudou	主導
zenmen	全面
sanchi	山地
bouryoku	暴力
###  3081 クレジット
###  3082 ロゴ
dasshutsu	脱出
tegami	手紙
###  3085 イラク
kyoumi	興味
## tomo	共	友
takameru	高める
## bi	微	美
###  3090 キャンパス
nomu	飲む
mushi	虫
nan	難
shujutsu	手術
sesshoku	接触
###  3096 キャラ
## samurai	侍	士
horyo	捕虜
hyousu	評す
###  3100 リチャード
###  3101 フットボール
shoten	書店
shageki	射撃
## shoukai	哨戒	紹介
rikon	離婚
kanazawa	金沢
ume	梅
kairo	回路
youto	用途
haitai	敗退
dainichi	大日
shoukin	賞金
ikka	一家
## ji	持	字
komeru	込める
## kounin	後任	公認
kageki	歌劇
mimi	耳
kazukazu	数々
bunmei	文明
koudan	講談
###  3122 ビッグ
###  3123 エース
asobu	遊ぶ
negau	願う
oji	伯父
hokubei	北米
denpa	電波
boumei	亡命
bungakubu	文学部
hoan	保安
kihei	騎兵
taki	滝
shunkou	竣工
## shuu	衆	州
shinnyuu	侵入
kion	気温
## rei	礼	例
semai	狭い
kaisen	海戦
zeniki	全域
senden	宣伝
shuuketsu	終結
oui	王位
## toru	採る	取る
###  3146 ランク
###  3147 フォード
osoi	遅い
kaisuu	回数
funsou	紛争
shain	社員
kokuyuu	国有
zairyou	材料
mensuru	面する
danchi	団地
katana	刀
sagasu	探す
###  3158 フィギュア
###  3159 コンセプト
renkei	連携
sonzoku	存続
hasei	派生
keiro	経路
shuryuu	主流
###  3165 ホワイト
kagayaku	輝く
kazuooi	数多い
suna	砂
ryousan	量産
oomune	概ね
seibun	成分
kissuru	喫する
###  3173 バトル
niku	肉
toujitsu	当日
kazan	火山
ijou	以上
taisa	大佐
###  3179 ライバル
## you	酔う	よう
## toubu	頭部	東部
bara	薔薇
akira	昭
shasen	車線
###  3185 スト
kimura	木村
boshuu	募集
## susumu	晋	進む
ryaku	略
juukyo	住居
atsuryoku	圧力
tokusei	特性
mujin	無人
kyouyuu	共有
###  3195 ソニー
senzen	戦前
###  3197 フランク
yashiki	屋敷
hatake	畑
dekigoto	出来事
tsumari	つまり
musashi	武蔵
koushite	こうして
hanpatsu	反発
## sou	僧	相
shinrin	森林
wakate	若手
## koi	濃い	恋
koukyuu	高級
shuuri	修理
seika	成果
###  3212 ネタ
## takashi	敬	隆
tanpen	短編
kuroi	黒い
souchaku	装着
## okuru	贈る	送る
jinsei	人生
yousai	要塞
###  3220 バイエルン
###  3221 サーバー
mitsukaru	見付かる
kaitaku	開拓
kamen	仮面
## ne	ね	根
## ka	課	科
###  3227 ナチス
shireru	知れる
kiban	基盤
shijin	詩人
###  3231 オール
ronri	論理
gimu	義務
buzoku	部族
zaisan	財産
tokoroga	ところが
kaiseki	解析
tougai	当該
hoppou	北方
###  3240 パス
###  3241 レスラー
nori	則
tanso	炭素
###  3244 パターン
## yu	由	湯
keika	経過
sukunakutomo	少なくとも
###  3248 ポケモン
## tsutomeru	勤める	務める
zaii	在位
kanshi	監視
kengen	権限
## kyou	強	教
tenkou	転向
sakugen	削減
sae	さえ
## hen	辺	編
## fu	婦	府
gaitou	該当
nikki	日記
oota	太田
shiga	滋賀
## shoki	書記	初期
###  3264 ルイス
sonna	そんな
jouin	上院
###  3267 シナリオ
kega	怪我
bugyou	奉行
ichiin	一員
sokushin	促進
daisuru	題する
###  3273 カレッジ
## ijou	異常	以上
saigai	災害
ouen	応援
konkyo	根拠
ichizukeru	位置付ける
ayamaru	誤る
shuushuu	収集
kagou	化合
shiten	支店
shinyou	信用
fureru	触れる
koyuu	固有
suteru	捨てる
hondo	本土
gorou	五郎
yakusho	役所
shokei	処刑
kasai	火災
###  3292 マガジン
matsuyama	松山
gakujutsu	学術
sabetsu	差別
shoen	初演
tsuukou	通行
###  3298 パッケージ
nazo	謎
## koukai	航海	公開
tadashii	正しい
aji	味
nakano	中野
## ken	軒	権
tosou	塗装
shusshi	出資
atochi	跡地
## shika	鹿	しか
date	伊達
tennen	天然
shouko	証拠
taishoku	退職
totsuzen	突然
###  3314 ジャケット
sotsu	卒
rakugo	落語
kiten	起点
hari	梁
shoujou	症状
###  3320 ブログ
###  3321 オーケストラ
###  3322 ユース
ittai	一帯
## kousha	校舎	後者
###  3325 デモ
zenki	前期
bushou	武将
kanarazu	必ず
arayuru	あらゆる
hokyuu	補給
kinrin	近隣
###  3332 スミス
genkyuu	言及
###  3334 ファミリー
###  3335 ステーション
maeda	前田
## seki	積	席
###  3338 アナログ
kaiyou	海洋
todoufuken	都道府県
shisan	資産
youin	要因
kurenai	紅
chikei	地形
nise	偽
shukushou	縮小
## seiki	正規	世紀
uesugi	上杉
jouen	上演
###  3350 ウイルス
soutei	想定
###  3352 ボストン
yuugen	有限
juken	受験
###  3355 ヤード
sousai	総裁
sekkin	接近
ikan	移管
jugyou	授業
kanraku	陥落
## susumeru	勧める	進める
###  3362 ハワイ
kinki	近畿
## ka	荷	科
chokkei	直径
saigen	再現
seiha	制覇
doku	独
tachiageru	立ち上げる
suisoku	推測
###  3371 キリスト
shusseki	出席
###  3373 ステークス
shiritsu	私立
kamo	かも
muku	向く
yowai	弱い
###  3378 リニューアル
kuushuu	空襲
tanshuku	短縮
###  3381 ハード
jinshu	人種
hazuda	はずだ
yoginai	余儀無い
nuno	布
kuwashii	詳しい
###  3387 ポスト
anda	安打
hougen	方言
shitsuryou	質量
osuuma	牡馬
###  3392 ワイン
uketoru	受け取る
odoru	踊る
###  3395 レーダー
yakan	夜間
touei	東映
chizu	地図
nankai	南海
## ha	歯	派
###  3401 ダブルス
###  3402 ブラウン
dasha	打者
manshuu	満州
## kin	菌	金
hinan	非難
soudan	相談
inshou	印象
yoseru	寄せる
zantei	暫定
yakusoku	約束
kain	下院
###  3413 ナポレオン
kyousan	共産
###  3415 ナンバー
## kata	肩	型
kansatsu	観察
## unkou	運航	運行
kanku	管区
koyou	雇用
## tama	多摩	玉
sentei	選定
###  3423 キャンプ
daizai	題材
kouzan	鉱山
###  3426 ラウンド
gaimu	外務
kunshou	勲章
###  3429 アート
###  3430 エドワード
wariai	割り合い
youryou	容量
## zai	材	剤
###  3434 ヒトラー
## saru	猿	去る
kenin	牽引
bannen	晩年
gakumei	学名
jokyouju	助教授
monbu	文部
sodateru	育てる
eiyuu	英雄
###  3443 ヘビー
ninjiru	任じる
kaijo	解除
## ikkan	一貫	一環
###  3447 ツール
shiraberu	調べる
kani	簡易
juudou	柔道
###  3451 フロント
chuusha	駐車
furukukara	古くから
chakuyou	着用
teisatsu	偵察
beigun	米軍
ishoku	移植
## suke	祐	介
youshou	幼少
kounai	構内
touhou	東宝
shingi	審議
sumou	相撲
hyoushou	表彰
###  3465 ブルガリア
## sou	創	相
gisei	犠牲
## zenmen	前面	全面
###  3469 フィリップ
tsunagu	繋ぐ
ma	魔
houki	放棄
kouiki	広域
fudousan	不動産
toukaidou	東海道
hougaku	法学
sousha	奏者
shindan	診断
bossuru	没する
fuman	不満
unchin	運賃
hakujin	白人
tte	って
tsugini	次に
## nou	農	能
bannin	番人
youyaku	ようやく
douin	動員
shichouson	市町村
kunshu	君主
kokuren	国連
senpaku	船舶
tsumaru	詰まる
mouri	毛利
ketsugi	決議
toukyoku	当局
unyu	運輸
###  3498 メッセージ
###  3499 クロアチア
jirei	事例
ningyou	人形
sonshou	損傷
###  3503 フロリダ
## roku	録	禄
###  3505 トム
kanpan	甲板
## shingaku	神学	進学
kenkai	見解
kaikan	会館
seikyuu	請求
genji	源氏
taiketsu	対決
kyuuden	宮殿
## kou	鋼	公
jishu	自主
naigai	内外
###  3517 コミックス
kokugun	国軍
unga	運河
## sou	双	相
###  3521 トレード
taidan	退団
teiji	提示
teiryuusho	停留所
## se	背	瀬
## gekkan	月間	月刊
rou	労
tentai	天体
###  3529 ニュージーランド
waki	脇
atsui	厚い
kougen	高原
###  3533 シングルス
haisen	敗戦
kongou	混合
###  3536 ヴィルヘルム
## ji	児	字
## kan	缶	間
denshou	伝承
###  3540 ラグビー
souri	総理
toge	刺
tsuyoshi	剛
###  3544 デザイナー
kanchou	艦長
saishin	最新
## yousei	養成	要請
###  3548 アラブshuchoukokurenpou
###  3549 ボス
hasu	蓮
shiku	敷く
taiki	大気
yahari	やはり
kouro	航路
ouyou	応用
## nami	並み	波
shomei	署名
maki	牧
doyoubi	土曜日
kemono	獣
sanso	酸素
## kai	解	回
jouryuu	上流
kankaku	間隔
## toujou	搭乗	登場
###  3566 マスター
joukyaku	乗客
## touhou	東方	東宝
chuuton	駐屯
kokujin	黒人
naosu	直す
kanei	寛永
akarui	明るい
usui	薄い
nitta	新田
###  3576 ボックス
satoshi	賢
## tsukaeru	使える	仕える
## koukei	口径	後継
gasshou	合唱
nichijou	日常
toppa	突破
## kousei	厚生	構成
noseru	乗せる
ongen	音源
toreru	取れる
keiryou	軽量
tantei	探偵
###  3589 プロセス
aruku	歩く
## atai	価	値
gyouseki	業績
mawasu	回す
ichijiteki	一時的
ateru	当てる
ryuushi	粒子
noumin	農民
nichiyoubi	日曜日
utsunomiya	宇都宮
hyougi	評議
###  3601 ワイド
toukou	投稿
zentei	前提
chouson	町村
###  3605 バージニア
###  3606 ルーマニア
neru	寝る
enjiru	演じる
uemon	右衛門
kirikaeru	切り替える
kensatsu	検察
senjutsu	戦術
kaikei	会計
suuchi	数値
nyuushou	入賞
###  3616 ショップ
nichiyou	日曜
anata	あなた
genkou	現行
suiiki	水域
utagau	疑う
###  3622 ダービー
## ya	弥	屋
kadai	課題
koubu	後部
kesu	消す
mitsukeru	見付ける
gyakuten	逆転
ichijirushii	著しい
seto	瀬戸
###  3631 レストラン
hinpan	頻繁
itoko	従兄弟
hoshii	欲しい
yamashiro	山城
engi	演技
###  3637 パフォーマンス
sanyou	山陽
###  3639 ペア
## hou	報	法
chuunichi	中日
gijuku	義塾
suitai	衰退
## kanryou	官僚	完了
## shounin	商人	承認
kyuutei	宮廷
kaiken	会見
renai	恋愛
shingata	新型
choumei	町名
koukaku	降格
nayamu	悩む
kyouin	教員
kaikou	開校
## han	判	版
naishi	ないし
## kakuritsu	確率	確立
kanjou	環状
###  3659 オンライン
gokan	互換
## kan	官	間
###  3662 マラソン
ougon	黄金
## hiroshi	裕	弘
## gou	豪	号
umai	上手い
kyakusha	客車
###  3668 ジャクソン
hanei	反映
seifuku	征服
###  3671 コート
mito	水戸
abiru	浴びる
tsuukin	通勤
ninzuu	人数
sounyuu	挿入
gakushou	楽章
shashu	車種
kasshoku	褐色
tekisetsu	適切
## ken	顕	権
jikoku	時刻
## hiroshi	宏	弘
geinin	芸人
shuuban	終盤
zenpou	前方
shikkan	疾患
## hayai	速い	早い
## kizuku	気付く	築く
shiiku	飼育
jizen	事前
###  3692 グランド
asshuku	圧縮
nigiru	握る
oudan	横断
###  3696 ヤング
todoku	届く
genroku	元禄
###  3699 バイオリン
kadou	稼働
donoyou	どのよう
###  3702 インターナショナル
chuudan	中断
naisen	内戦
osoraku	恐らく
waru	割る
junkan	循環
## yutaka	豊か	豊
aoyama	青山
wakamono	若者
###  3711 パートナー
meijiru	命じる
otona	大人
totsunyuu	突入
## masa	雅	昌
## kyoudou	協同	共同
###  3717 コメディー
zumeru	詰める
sura	すら
hibi	日々
koushien	甲子園
kamaeru	構える
konryuu	建立
hankyuu	阪急
kurihirogeru	繰り広げる
kouan	考案
sousaku	創作
## moukeru	儲ける	設ける
yuuki	有機
houtou	砲塔
###  3731 トヨタ
shimazu	島津
shiei	市営
kijou	騎乗
noriba	乗り場
hikouki	飛行機
ro	炉
## ishi	意思	石
shutoshite	主として
###  3740 チェコ
###  3741 コント
## takeshi	健	武
## bou	棒	房
###  3744 テロ
meichuu	命中
tokei	時計
gaikan	外観
dokusha	読者
shoumen	正面
kousaku	工作
kaihen	改編
## yaku	焼く	役
hirogeru	広げる
gimon	疑問
###  3755 サンフランシスコ
fuyasu	増やす
zoudai	増大
kyoushitsu	教室
shakaitou	社会党
###  3760 オリコン
###  3761 コロンビア
tate	縦
fuu	封
jitsuryoku	実力
###  3765 マッチ
###  3766 パート
kokochi	心地
hirei	比例
shuuten	終点
tomoshibi	灯
## kansuru	冠する	関する
hihyou	批評
senjou	戦場
## dai	題	台
## kaishuu	回収	改修
kasoku	加速
tounan	東南
## hen	変	編
###  3779 ショッピング
nanraka	何等か
u	卯
## mon	紋	門
genri	原理
## ninki	任期	人気
chuukaminkoku	中華民国
shinpan	審判
ronsou	論争
###  3788 リトアニア
ninzuru	任ずる
sozai	素材
houfu	豊富
shoubu	勝負
haizoku	配属
## kaihou	開放	解放
###  3795 シンガポール
shumoku	種目
shougi	将棋
zensha	前者
## tsuuka	通貨	通過
shuushi	修士
###  3801 タッチ
nijuu	二重
dengen	電源
mokei	模型
###  3805 モチーフ
shougen	証言
###  3807 ブック
###  3808 テープ
ketsui	決意
###  3810 チベット
###  3811 ドライブ
konasu	こなす
taichou	隊長
mikuni	三国
haifu	配布
sakanoboru	遡る
kappatsu	活発
katawara	傍ら
## shu	朱	主
hyakkaten	百貨店
zaimu	財務
yuugata	夕方
## me	眼	目
## sakai	堺	境
## oosaka	大坂	大阪
kokyou	故郷
###  3827 タンク
ninka	認可
kassen	合戦
hantoshi	半年
yuuryou	有料
mitsui	三井
omomuku	赴く
mukashi	昔
## soko	底	そこ
uwasa	噂
###  3837 グレード
tanken	探検
bunshou	文章
genkai	限界
## shin	秦	信
hougakubu	法学部
doujin	同人
###  3844 レンズ
juugun	従軍
nobasu	伸ばす
akuma	悪魔
naimu	内務
dokusen	独占
kakutou	格闘
douryoku	動力
###  3852 minamiアフリカ
joukyuu	上級
###  3854 パーティー
nyuumon	入門
###  3856 センチ
shougeki	衝撃
###  3858 タイヤ
jinguu	神宮
## eisei	衛生	衛星
sainou	才能
hashimoto	橋本
houan	法案
###  3864 ウエスト
###  3865 ウッド
## sumu	済む	住む
suijou	水上
###  3868 マイ
###  3869 レンタル
haijo	排除
sukuu	救う
houshutsu	放出
haiki	排気
ogawa	小川
###  3875 オーディション
fumu	踏む
hinba	牝馬
hokuriku	北陸
suidou	水道
## tou	登	党
ninchi	認知
###  3882 フィル
## nori	憲	則
kokuseki	国籍
yamazaki	山崎
## tei	邸	定
juku	塾
## kousou	抗争	構想
choukoku	彫刻
###  3890 ディレクター
tabako	たばこ
###  3892 マイク
###  3893 トラブル
teimei	低迷
## kouzan	高山	鉱山
taishuu	大衆
hougeki	砲撃
## mune	胸	旨
toubou	逃亡
zensen	全線
koori	氷
maisou	埋葬
## utsu	討つ	打つ
kyuusei	旧制
## heru	減る	経る
## sha	舎	社
shuyaku	主役
fugou	符号
nanpou	南方
kaikyoku	開局
joshu	助手
## zensen	前線	全線
soudou	騒動
kuuchuu	空中
## yo	余	世
kanarazushimo	必ずしも
## maku	膜	巻く
sangaku	山岳
###  3919 ミュンヘン
tettei	徹底
ore	俺
haikyuu	配給
nagaraku	長らく
hachiman	八幡
###  3925 キック
gyouji	行事
harau	払う
###  3928 ジョンソン
###  3929 オフィス
yue	故
###  3931 コンテンツ
rakusen	落選
cho	著
taieki	退役
kitakyuushuu	北九州
kashiwa	柏
shuuki	周期
ju	受
## ko	庫	子
###  3940 クロス
koueki	交易
nyuujou	入場
tainin	退任
kenshutsu	検出
kinyoubi	金曜日
###  3946 トレーニング
chuutai	中隊
taiseiyou	大西洋
###  3949 キャンペーン
itai	遺体
###  3951 インドネシア
###  3952 リア
mushiro	寧ろ
###  3954 ベイ
kenkoku	建国
heigou	併合
zetsumetsu	絶滅
hontou	本当
###  3959 オールスター
## bou	傍	房
###  3961 エア
fusetsu	敷設
kawauchi	河内
hazusu	外す
kanten	観点
###  3966 コンテスト
megumu	恵む
hensan	編纂
kennin	兼任
isu	椅子
###  3971 マーケット
yubi	指
###  3973 ファイナル
gakunen	学年
kyouwatou	共和党
## shiryou	史料	資料
## ittai	一体	一帯
gakumon	学問
ichikawa	市川
## hiru	昼	昼
shirou	四郎
sentai	船体
zenkai	前回
###  3984 タワー
###  3985 コマンド
chouhen	長編
## katsu	活	勝つ
kasu	化す
soumu	総務
## joukyou	上京	状況
haruka	遥か
moshi	もし
a	あ
###  3994 ゴールデン
hikiageru	引き上げる
## kigen	期限	紀元
tenkei	典型
suu	崇
hakushaku	伯爵
teisuu	定数
baba	馬場
nukeru	抜ける
###  4003 ジョー
###  4004 ハート
## kai	かい	回
denka	電化
## kiku	菊	聞く
hendou	変動
###  4009 シンガー
## mushi	無視	虫
busshi	物資
## kou	航	公
gakui	学位
kenshuu	研修
gorin	五輪
ogura	小倉
sorou	揃う
## kai	甲斐	回
tousou	闘争
fuufu	夫婦
okada	岡田
katai	堅い
## shi	氏	市
###  4024 ジェット
ueda	上田
tonaeru	唱える
saichuu	最中
shitashimu	親しむ
###  4029 コントロール
jinken	人権
nakashima	中島
###  4032 ダウンロード
botsunen	没年
wariateru	割り当てる
ritchi	立地
###  4036 バレエ
shisha	死者
noudo	濃度
ryakureki	略歴
yuugou	融合
## tokuten	特典	得点
chakushu	着手
###  4043 ウィリアムズ
kougou	皇后
## seki	籍	席
murakami	村上
shihan	師範
###  4048 ポンド
###  4049 シャー
## kyouka	教科	強化
## gen	限	現
soukai	総会
heisetsu	併設
kyuuryou	丘陵
housoku	法則
sosogu	注ぐ
## gi	議	義
gasshuukoku	合衆国
## gen	弦	現
###  4060 アレンジ
###  4061 プレーオフ
nyuushoku	入植
koromo	衣
###  4064 ガン
yasumu	休む
ensen	沿線
taoreru	倒れる
touki	登記
###  4069 コンクール
saishou	最小
saiko	最古
daten	打点
yosoku	予測
kyouchou	強調
bushi	武士
kourei	高齢
takada	高田
###  4078 ディズニー
###  4079 ライフ
sotogawa	外側
## tou	投	党
ryuukyuu	琉球
shimane	島根
ryoushu	領主
yokosuka	横須賀
## shou	証	賞
kouzui	洪水
###  4088 ボート
## taka	鷹	高
taihen	大変
kiiro	黄色
sasaki	佐々木
tanoshimu	楽しむ
###  4094 タクシー
fuka	付加
hiromaru	広まる
tozan	登山
## chuutai	中退	中隊
narita	成田
kaijuu	怪獣
reki	歴
###  4102 キャスター
shikamo	しかも
kaisou	改装
kouchou	校長
hiritsu	比率
hosokawa	細川
###  4108 メタル
odoroku	驚く
soushoku	装飾
saiseiki	最盛期
## kakaru	掛かる	係る
tamashii	魂
murasaki	紫
###  4115 ユーゴスラビア
su	巣
oboeru	覚える
sasou	誘う
shosen	緒戦
jinryoku	尽力
kotowaru	断る
## ikou	意向	以降
kyuujo	救助
sannyuu	参入
sanchou	山頂
###  4126 コア
###  4127 オプション
## you	要	よう
osanai	幼い
###  4130 フォーク
## sha	斜	社
hikaeru	控える
kensaku	検索
seijin	成人
###  4135 パネル
minaosu	見直す
## hinan	避難	非難
misaki	岬
###  4139 ストリート
yousuru	擁する
tokushuu	特集
###  4142 マリー
uchikiru	打ち切る
shiiru	強いる
hitome	人目
###  4146 ハッキリ
kansou	乾燥
## touki	冬季	登記
###  4149 ヨハン
shiryuu	支流
kinyou	金曜
###  4152 ポート
niwa	庭
ritsu	律
hazureru	外れる
## kousei	恒星	構成
seizon	生存
kagi	鍵
## senkou	選考	先行
juritsu	樹立
###  4161 ロス
## shusai	主宰	主催
jikou	事項
inyou	引用
shinano	信濃
serifu	台詞
wada	和田
## kyuu	休	旧
jikkyou	実況
hairetsu	配列
herasu	減らす
###  4172 オン
uriage	売上
oono	大野
doutou	同等
###  4176 ローラー
mawari	周り
###  4178 ボーナス
chakuriku	着陸
gyouretsu	行列
###  4181 アドレス
shouchiku	松竹
###  4183 アルコール
doryoku	努力
## kousha	公社	後者
###  4186 シドニー
gensokutoshite	原則として
yougi	容疑
###  4189 コンクリート
###  4190 プレイステーション
gekiha	撃破
taiin	隊員
shuushoku	就職
kyousoukyoku	協奏曲
## ki	軌	機
###  4196 ヒーロー
## ito	糸	意図
fusai	夫妻
tagaini	互いに
## hara	腹	原
kieru	消える
chuukaku	中核
###  4203 ファースト
uchigawa	内側
hokan	保管
toudai	東大
choufuku	重複
## arawasu	現す	表す
fuukei	風景
konoe	近衛
sugi	杉
###  4212 ケン
ekitai	液体
soshi	阻止
###  4215 アラビア
chichuukai	地中海
###  4217 ミュージカル
bochi	墓地
tojiru	閉じる
chuu	駐
taifuu	台風
###  4222 アダルト
kango	看護
###  4224 フィラデルフィア
naze	何故
hassu	発す
oomiya	大宮
haze	櫨
juugyou	従業
###  4230 フレーム
###  4231 ラブ
jitsuha	実は
souchou	総長
ooshima	大島
kakusha	各社
###  4236 モンスター
## kanjou	感情	環状
taido	態度
shutsudo	出土
mochiron	もちろん
tsuji	辻
nissan	日産
###  4243 フェスティバル
nakagawa	中川
nuru	塗る
joukou	乗降
karyuu	下流
toukyuu	東急
satsu	札
###  4250 エリザベス
houteki	法的
## masu	鱒	増す
###  4253 アウト
inkyo	隠居
bariki	馬力
hosa	補佐
bokujou	牧場
tenshi	天使
toushiba	東芝
shigeki	刺激
tamura	田村
jourei	条例
shitsumon	質問
###  4264 ニック
aoi	青い
shineitai	親衛隊
satsuma	薩摩
bunsan	分散
mu	無
###  4270 ピーター
## ryouhou	療法	両方
genmitsu	厳密
## hoshou	保証	保障
junji	順次
## ho	帆	保
## koutai	後退	交代
shochou	所長
taisha	退社
gihou	技法
###  4280 トイレ
###  4281 ドキュメンタリー
kangen	管弦
keru	蹴る
metsubou	滅亡
houteishiki	方程式
yumi	弓
hakata	博多
kaiiki	海域
kaiko	解雇
## hiroshi	浩	弘
itonamu	営む
sensei	先生
toyotomi	豊臣
makasu	任す
shouryaku	省略
tango	単語
ono	小野
sayoku	左翼
boutou	冒頭
###  4300 クーデター
fushin	不振
oubo	応募
###  4303 マイクロ
gyogyou	漁業
shussan	出産
## kesshou	結晶	決勝
hatchuu	発注
kifu	寄付
## sasu	刺す	指す
## kawa	皮	川
hakodate	函館
## henkan	返還	変換
touzen	当然
###  4314 ラリー
###  4315 ゾーン
hachi	蜂
shoutai	招待
naizou	内蔵
## touchi	当地	統治
nomura	野村
###  4321 ダブル
furyou	不良
###  4323 シャルル
ryuuyou	流用
###  4325 ホンダ
###  4326 オハイオ
oi	甥
kounen	後年
meshi	飯
###  4330 オーナー
dougu	道具
## noboru	昇	上る
tousei	統制
## ran	蘭	乱
###  4335 スタンド
fuan	不安
## gi	儀	義
souzou	創造
sai	彩
ishii	石井
youchien	幼稚園
souken	創建
denatsu	電圧
ishin	維新
shunin	主任
nari	なり
## sei	静	正
shuufuku	修復
majiwasu	交わす
hisho	秘書
hannin	犯人
suihei	水平
kessuru	決する
## shiten	視点	支店
jishoku	辞職
###  4356 ブルース
hakkaku	発覚
## zou	象	像
###  4359 ヒロイン
###  4360 カテゴリー
## kakou	河口	加工
arashi	嵐
## ki	季	機
konkai	今回
## kan	幹	間
jugoi	従五位
daikanminkoku	大韓民国
tekisu	適す
shinkoku	深刻
minei	民営
miura	三浦
daidai	代々
yuuri	有利
###  4374 デイヴィッド
chinatsu	鎮圧
###  4376 プロモーション
yobikakeru	呼び掛ける
ine	稲
mitsuo	三男
kiyo	寄与
###  4381 ダイヤモンド
henkei	変形
eiroku	永禄
## ho	穂	保
mizo	溝
toshin	都心
suijun	水準
###  4388 マスコミ
## shirusu	著す	記す
tsugeru	告げる
###  4391 インター
## sen	銭	線
idomu	挑む
bungei	文芸
mai	舞
chousha	庁舎
shinsaku	新作
kobushi	拳
###  4399 ハム
fukuin	福音
###  4401 プロセッサ
baishou	賠償
oumi	近江
madoguchi	窓口
kaimetsu	壊滅
###  4406 サークル
###  4407 ガソリン
###  4408 バルセロナ
doui	同意
ishou	衣装
mino	美濃
hinshitsu	品質
yokusei	抑制
koibito	恋人
## kansen	幹線	感染
## kouka	降下	効果
kaihei	海兵
kizamu	刻む
zan	残
## jikan	次官	時間
###  4421 プレミア
bakumatsu	幕末
## hoken	保健	保険
## saku	割く	作
###  4425 キューバ
buka	部下
gekitsui	撃墜
wasureru	忘れる
henshin	変身
maikai	毎回
gakku	学区
## taishi	太子	大使
## kouen	講演	公園
sekitan	石炭
jo	序
hittou	筆頭
keikai	警戒
gekichuu	劇中
choutei	朝廷
###  4440 ドラム
###  4441 ノミネート
###  4442 プレート
shisa	示唆
## fu	譜	府
rittai	立体
omonaru	重なる
gyakusatsu	虐殺
toho	徒歩
hongoku	本国
###  4450 テーブル
machigau	間違う
kyuujitsu	休日
taikuu	対空
shutsugeki	出撃
touin	党員
kaga	加賀
teien	庭園
shui	首位
###  4459 パック
shugyou	修行
angou	暗号
kencho	顕著
kakujitsu	確実
shuuritsu	州立
## an	暗	案
nakademo	中でも
###  4467 ステップ
###  4468 メイト
###  4469 フライ
koumu	公務
sakujo	削除
###  4472 トランス
## shinsei	神聖	申請
shinzou	心臓
shoushitsu	焼失
###  4476 ヘリコプター
###  4477 ジャーナリスト
hamamatsu	浜松
hairyo	配慮
roukyuu	老朽
suisei	彗星
futago	双子
shiriau	知り合う
## kangen	還元	管弦
wareware	我々
###  4486 プロテスタント
## toshi	敏	都市
ushiro	後ろ
## setsu	切	説
## yousuru	要する	擁する
sanshin	三振
shouhyou	商標
###  4493 クリスマス
## juu	従	重
## ho	歩	保
kyougou	競合
hiza	膝
joumu	乗務
fukuda	福田
kainin	解任
## jushou	受章	受賞
###  4502 ピン
atsushi	淳
shoukou	将校
###  4505 レール
miidasu	見出だす
tayoru	頼る
mikata	味方
## rou	老	労
settoku	説得
hino	日野
sumitomo	住友
## koukou	航行	高校
saitou	斎藤
karou	家老
yakuin	役員
nagaoka	長岡
hakusu	博す
mikawa	三河
## kouka	高架	効果
genso	元素
shinryaku	侵略
mitsu	密
zenpan	全般
## kiku	聴く	聞く
monshou	紋章
## asa	麻	朝
keni	権威
dasshu	奪取
karate	空手
gekichin	撃沈
koudai	広大
keihan	京阪
## ryou	寮	量
###  4535 カーブ
###  4536 チェーン
###  4537 マサチューセッツ
choujo	長女
mishima	三島
chian	治安
kouwan	港湾
iori	庵
shikakeru	仕掛ける
hirakeru	開ける
seihou	西方
kenen	懸念
###  4547 ゴールド
###  4548 マイナー
namegata	行方
kantei	艦艇
###  4551 シリア
sakidatsu	先立つ
## shun	駿	俊
###  4554 マップ
juuryoku	重力
mikomu	見込む
funou	不能
haishutsu	輩出
gara	柄
###  4560 ペンシルベニア
###  4561 ライヴ
tsuuro	通路
houhei	砲兵
## in	陰	員
fuyo	付与
oru	折る
kanwa	緩和
naraberu	並べる
###  4569 バランス
inoshishi	猪
aizu	会津
keimusho	刑務所
jinji	人事
ansei	安政
oyobosu	及ぼす
rikuchi	陸地
###  4577 ニッポン
nishiki	錦
shinju	真珠
mokuzou	木造
## kankaku	感覚	間隔
tenyou	転用
shirizoku	退く
tsugou	都合
kainyuu	介入
###  4586 アテネ
kabunushi	株主
## go	護	語
youbou	要望
yattekuru	やってくる
dannen	断念
###  4592 リスク
###  4593 フォー
## kayou	歌謡	通う
futa	蓋
kobetsu	個別
choukyou	調教
kenshu	犬種
kanban	看板
###  4600 カンパニー
###  4601 ジョーンズ
## shio	潮	塩
nettai	熱帯
## kami	髪	神
zenbu	全部
###  4606 シンボル
senjuu	先住
taii	大尉
shadan	社団
kuki	茎
joushu	城主
tokusatsu	特撮
## han	班	版
###  4614 プラットフォーム
nairiku	内陸
kentei	検定
###  4617 ビール
###  4618 クリス
koufu	甲府
sakamoto	坂本
###  4621 ユナイテッド
miteru	充てる
###  4623 ラッシュ
mibun	身分
miki	三木
botsu	没
kaisui	海水
kaidan	階段
###  4629 アーケード
###  4630 スコット
fusei	不正
genjou	現状
###  4633 タイガース
## shikou	施工	施行
enzetsu	演説
teinen	定年
koushaku	公爵
###  4638 ランプ
###  4639 マンション
###  4640 オー
## shihan	市販	師範
nabe	鍋
fukuyama	福山
###  4644 マルクス
###  4645 マルチ
jissen	実践
jinzai	人材
heiryoku	兵力
## dendou	殿堂	電動
suisan	水産
###  4651 パーツ
###  4652 コール
###  4653 ギタリスト
teiin	定員
kakutougi	格闘技
funiki	雰囲気
###  4657 パイプ
## furu	降る	振る
hebi	蛇
saikyou	最強
hakuran	博覧
tadachini	直ちに
## hari	針	梁
###  4664 スカウト
jitsuzai	実在
## houki	蜂起	放棄
geimei	芸名
###  4668 マネージャー
nenji	年次
tooi	遠い
sabaku	砂漠
osen	汚染
rikishi	力士
seishun	青春
choutatsu	調達
koukogaku	考古学
hinkon	貧困
## yuu	結う	優
shindou	振動
###  4680 グラフィック
kaizoku	海賊
###  4682 スリー
saitaku	採択
honten	本店
eiyou	栄養
yamashita	山下
juujitsu	充実
ouritsu	王立
## hoshu	捕手	保守
###  4690 アシスタント
hyoushi	表紙
shokuji	食事
shozou	所蔵
shikumu	仕組む
furitsu	府立
###  4696 プール
benkyou	勉強
shouzou	肖像
chuuban	中盤
sagaru	下がる
heimen	平面
tosa	土佐
taeru	耐える
bonchi	盆地
kisetsu	季節
minshuu	民衆
## akira	朗	昭
###  4708 ロードレース
senpai	先輩
gotou	後藤
enshuu	演習
kouza	講座
karui	軽い
yakusu	訳す
shakuhou	釈放
enshin	延伸
kokumu	国務
## jirou	二郎	次郎
noda	野田
shuudou	修道
## tsune	恒	常
demise	出店
kariru	借りる
iyaku	医薬
## tsui	追	対
kidousha	気動車
shuuto	州都
suikei	水系
## koko	個々	ここ
fuchi	淵
## doku	毒	独
suiri	推理
###  4733 キャッチ
###  4734 ビーチ
keiki	契機
shitten	失点
torimodosu	取り戻す
waka	和歌
shokuryou	食料
###  4740 ポップ
gekka	月下
genryou	原料
fukuro	袋
###  4744 ゲート
heiyou	併用
###  4746 チリ
kousen	交戦
seni	繊維
rikigaku	力学
ookura	大蔵
odawara	小田原
###  4752 プログラミング
## heikou	平行	並行
## seishitsu	正室	性質
narabini	並びに
## gen	言	現
kantsuu	貫通
shutsunyuu	出入
hyouban	評判
oyama	小山
sageru	下げる
chinbotsu	沈没
abe	阿部
###  4764 スポット
zenjitsu	前日
kyuuen	救援
hiro	ひろ
chikazuku	近付く
kyuusha	厩舎
hinshu	品種
chosha	著者
ueru	植える
kaiwa	会話
###  4774 ベクトル
sakuga	作画
denchi	電池
enzan	演算
shoji	所持
kaisu	介す
sennen	専念
kirau	嫌う
## toushu	党首	投手
getsuyou	月曜
## juyou	受容	需要
## keisei	京成	形成
ryakusu	略す
taisho	対処
kanketsu	完結
kyo	挙
yasei	野生
###  4791 チャンピオンシップ
keishi	警視
## jouin	乗員	上院
## kaidan	会談	階段
batteki	抜擢
nikkou	日光
daigakkou	大学校
danyaku	弾薬
## utsu	撃つ	打つ
## tayou	多用	多様
###  4801 ハリウッド
nogasu	逃す
## han	犯	版
hakushoku	白色
sanchuu	山中
## kansei	寛政	完成
reikyaku	冷却
###  4808 ストレート
enki	延期
nyuuin	入院
###  4811 メス
teiri	定理
kanda	神田
suichoku	垂直
shinpo	進歩
fujita	藤田
chuutou	中等
on	恩
chimeido	知名度
aisu	愛す
kyokusen	曲線
###  4822 アンテナ
###  4823 ゴム
###  4824 ハインリヒ
kawara	河原
## haishutsu	排出	輩出
###  4827 ヴェネツィア
souki	早期
yoyaku	予約
okazaki	岡崎
kuri	栗
gakuchou	学長
kyouku	教区
kokyaku	顧客
kachou	課長
himeji	姫路
genkei	原型
zanryuu	残留
jaku	弱
## kani	官位	簡易
## kai	貝	回
## fuji	不治	藤
kyouyou	教養
###  4844 ヴァン
fushigi	不思議
###  4846 ゲージ
shako	車庫
###  4848 データベース
###  4849 マネジメント
kichou	貴重
sebangou	背番号
###  4852 キャプテン
fukugen	復元
fuantei	不安定
## jouhou	上方	情報
shousa	少佐
hourei	法令
hensuu	変数
## wakareru	別れる	分かれる
kaseki	化石
nareru	慣れる
## ken	謙	権
###  4863 サーキット
###  4864 ファンタジー
## tatsu	辰	立つ
shusshou	出生
toritsu	都立
myou	妙
###  4869 チャンピオンズ
## kougaku	光学	工学
juusho	住所
kokusan	国産
totsugeki	突撃
hangeki	反撃
junsui	純粋
###  4876 ジョージア
## take	丈	竹
deguchi	出口
kakukaku	各々
koizumi	小泉
shukuhaku	宿泊
bougai	妨害
gishi	技師
jiyuuminshutou	自由民主党
motto	もっと
## kidou	起動	軌道
echigo	越後
kurushimu	苦しむ
zainin	在任
hanshi	藩士
toukatsu	統括
###  4892 アトランタ
asakusa	浅草
ware	我
un	運
## kaisen	開戦	海戦
kingaku	金額
hitachi	日立
seiyaku	制約
###  4900 イスラーム
## shi	詞	市
## taishou	対称	対象
nenkin	年金
hatsudou	発動
###  4905 ジャイアンツ
tomu	富む
boin	母音
aoki	青木
kusari	鎖
toyoda	豊田
###  4911 シェア
fumoto	麓
sansei	賛成
kondou	近藤
zoukyou	増強
jigoku	地獄
###  4917 ホームページ
monka	門下
tsukusu	尽くす
###  4920 リゾート
risou	理想
hisai	被災
kannon	観音
###  4924 ザクセン
## taishou	対照	対象
tansa	探査
izu	伊豆
###  4928 ドコモ
tokuhyou	得票
suichuu	水中
nensho	年初
## kousoku	拘束	高速
kassou	滑走
## shika	歯科	しか
###  4935 ロッテ
###  4936 レーシング
ikinokoru	生き残る
## tate	盾	縦
tooru	徹
otoru	劣る
megami	女神
tsuugaku	通学
nenshou	燃焼
chouten	頂点
###  4945 バイク
kyoufu	恐怖
nanimo	何も
tsubame	燕
## kiso	起訴	基礎
hansha	反射
## saikin	細菌	最近
shuukai	集会
###  4953 ノー
###  4954 ドラemon
gogen	語源
## chichi	乳	父
###  4957 コンテナ
## ouji	皇子	王子
kaitei	改訂
romen	路面
## han	範	版
## seido	精度	制度
gatsuchuu	月中
kawakami	川上
yoshimoto	吉本
sonshitsu	損失
kumano	熊野
## kougi	講義	抗議
nourin	農林
kasha	貨車
morioka	盛岡
###  4972 エレベーター
## sakura	さくら	桜
reibou	冷房
###  4975 ターボ
houdan	砲弾
to	斗
kiatsu	気圧
tsutomu	務
takasaki	高崎
###  4981 セントラル
###  4982 アレクサンドル
###  4983 ショート
saimu	債務
ooini	大いに
###  4986 メロディ
###  4987 ロイヤル
kyoui	脅威
###  4989 ラスト
yoshino	吉野
## hana	鼻	花
ouhi	王妃
###  4993 ベルト
tsukuba	筑波
sarasu	晒す
###  4996 ノース
naritatsu	成り立つ
###  4998 マケドニア
###  4999 マドリード
###  5000 ミドル
###  5001 アラン
musubitsuku	結び付く
## kaikan	開館	会館
###  5004 プラン
ootsu	大津
gakushi	学士
###  5007 イエス
yokoku	予告
###  5009 アンリ
###  5010 シュート
###  5011 バンク
###  5012 メアリー
###  5013 イリノイ
## kouka	工科	効果
## umu	産む	生む
## koushi	行使	講師
## toku	解く	徳
###  5018 アーサー
###  5019 ピエール
## nozomu	臨む	望む
## utsusu	写す	移す
###  5022 バレー
komakai	細かい
kabuki	歌舞伎
doutai	胴体
kasa	笠
unagasu	促す
###  5028 チャンス
ikki	一気
shisen	支線
kamoku	科目
## seinen	生年	青年
## toru	執る	取る
kakunou	格納
kasou	仮想
karamu	絡む
###  5037 ミステリー
chuugakusei	中学生
kondo	今度
ogasawara	小笠原
## noseru	載せる	乗せる
###  5042 ピンク
shikibetsu	識別
## akira	亮	昭
###  5045 ネ
###  5046 ダメージ
###  5047 テキスト
gaiken	外見
kaitou	回答
## kouhou	広報	後方
hassuru	発する
###  5052 バン
## tsutsu	筒	つつ
kujira	鯨
###  5055 フランツ
## jiki	磁気	時期
sankaku	三角
keidai	境内
tachibana	橘
yami	闇
## shisha	支社	死者
###  5062 チェンジ
etsuran	閲覧
hifu	皮膚
tsuzuru	綴る
## jissen	実戦	実践
ugokasu	動かす
igakubu	医学部
hasegawa	長谷川
shourei	奨励
ryouchi	領地
rippou	立法
kinsei	近世
daikou	代行
tsutsumu	包む
###  5076 レスリング
nenhan	年半
shotoku	所得
## na	菜	な
## tsuushou	通商	通称
###  5081 ピアニスト
###  5082 キーボード
eibun	英文
guuzen	偶然
###  5085 チップ
kashou	歌唱
fude	筆
sakutei	策定
honsuu	本数
## han	繁	版
## tokui	特異	得意
souguu	遭遇
matagaru	跨がる
katameru	固める
shinagawa	品川
anka	安価
suwa	諏訪
kyokutan	極端
## kashi	菓子	歌詞
gishiki	儀式
###  5101 スコア
houtei	法廷
###  5103 ローズ
tenki	天気
kyoudo	強度
###  5106 ユーロ
akumade	あくまで
fujou	浮上
## ban	晩	番
botai	母体
kamu	噛む
rinshou	臨床
miryoku	魅力
joujutsu	上述
okonaeru	行える
###  5116 チャレンジ
###  5117 グレート
###  5118 アイデア
nesshin	熱心
hitoshii	等しい
iida	飯田
## ikki	一揆	一気
## kyougou	強豪	競合
## satou	砂糖	佐藤
kiri	桐
###  5126 カルロス
###  5127 ソース
choueki	懲役
## chuu	宙	駐
shoushuu	招集
budou	葡萄
###  5132 オレンジ
koubai	勾配
###  5134 ピーク
senzoku	専属
###  5136 リレー
shinzuru	信ずる
## saitama	さいたま	埼玉
###  5139 ウェールズ
###  5140 ボクサー
## gen	減	現
tana	棚
yorokobu	喜ぶ
mukou	無効
teisu	呈す
hokou	歩行
###  5147 アール
kenshou	検証
###  5149 ドラ
kohi	珈琲
## hanei	繁栄	反映
ashita	明日
seigi	正義
tousan	倒産
maboroshi	幻
doujou	道場
kashima	鹿島
ryokushoku	緑色
###  5159 ホールディングス
nankin	南京
## mikata	見方	味方
###  5162 ハードウエア
###  5163 ガード
houmu	法務
gangu	玩具
dentatsu	伝達
## shin	伸	信
kyuugeki	急激
###  5169 リズム
## kikou	起工	機構
taku	宅
fuyou	不要
###  5173 レーザー
sakaeru	栄える
###  5175 ボーイング
maitsuki	毎月
kyouryou	橋梁
###  5178 サイクル
sakigakeru	先駆ける
taitou	台頭
akirakasu	明かす
ookubo	大久保
## suzuki	すずき	鈴木
###  5184 ゲイ
suiro	水路
###  5186 プラス
konchuu	昆虫
koru	刳る
shiboru	絞る
shokunin	職人
kakushin	革新
## tonaeru	称える	唱える
sakufuu	作風
ihou	違法
###  5195 ベースボール
###  5196 オートバイ
## tsuru	吊る	鶴
komatsu	小松
rettou	列島
funka	噴火
namida	涙
urawa	浦和
karasu	烏
ginou	技能
houjiru	報じる
shobou	書房
chourui	鳥類
hakone	箱根
senshoku	染色
## dan	談	団
toushuu	踏襲
###  5212 アドベンチャー
## kousou	高層	構想
## budou	武道	葡萄
totemo	とても
dore	どれ
hanji	判事
ryoukou	良好
sasa	笹
ninshin	妊娠
ano	あの
douryou	同僚
yuui	優位
koya	小屋
owari	尾張
## midori	みどり	緑
kakudo	角度
## kotaeru	応える	答える
## itou	伊東	伊藤
hokaku	捕獲
###  5231 オブジェクト
## kougyou	興業	工業
banchi	番地
senshin	先進
###  5235 ミラー
matsuda	松田
tsunami	津波
koshi	腰
## haiki	廃棄	排気
## ken	研	権
## shuchou	首長	主張
## shibou	脂肪	死亡
yousui	用水
shougatsu	正月
hasshou	発症
## kaku	覚	角
hokkai	北海
###  5248 ブライアン
## kaku	欠く	角
getsuyoubi	月曜日
keikoku	渓谷
chishitsu	地質
tanitsu	単一
horobosu	滅ぼす
shousan	称賛
###  5256 イースト
tsuiraku	墜落
shougakusei	小学生
mimau	見舞う
gimi	誼み
###  5261 アルゴリズム
###  5262 ペース
akaji	赤字
gunyou	軍用
###  5265 テネシー
###  5266 モジュール
## kaki	夏季	書
tanjoubi	誕生日
###  5269 ヤマト
youritsu	擁立
kossetsu	骨折
morau	貰う
## men	綿	面
hatamoto	旗本
kessen	決戦
ton	問
shokubai	触媒
tenjou	天井
jousei	情勢
jinei	陣営
###  5281 キャスト
reihai	礼拝
###  5283 ルー
## zenshin	全身	前身
kasuga	春日
joban	序盤
yatsu	奴
kouban	降板
## yuukou	友好	有効
seimu	政務
chiyoda	千代田
shihei	紙幣
###  5293 ドラゴン
keisha	傾斜
rakuen	楽園
shiseki	史跡
###  5297 リメイク
###  5298 ダニエル
## shou	少	賞
ryuushutsu	流出
## hai	灰	敗
tadai	多大
iwaku	曰く
###  5304 リンカーン
shahon	写本
denryuu	電流
ooyama	大山
## souchou	早朝	総長
kokyuu	呼吸
kouteki	公的
## taru	樽	足る
## sousaku	捜索	創作
kane	鐘
## kei	径	系
asahihousou	朝日放送
shunkan	瞬間
###  5317 ピット
## kanji	幹事	漢字
## minzoku	民俗	民族
## noboru	登る	上る
uyoku	右翼
## wakai	和解	若い
## satoshi	悟	賢
taisou	体操
toriwake	とりわけ
###  5326 マレーシア
###  5327 スケール
## aku	明く	悪
bouen	望遠
yobou	予防
###  5331 ケンタッキー
inshoku	飲食
## kaitei	海底	改訂
###  5334 ストア
###  5335 ダート
###  5336 ミラノ
sougaku	総額
shukka	出荷
yakusha	役者
###  5340 クラーク
dokusai	独裁
seitai	生態
###  5343 カンザス
tokka	特化
## kiku	利く	聞く
kikin	基金
fushimi	伏見
shokumu	職務
kakko	括弧
datsu	脱
## ari	蟻	有
iden	遺伝
###  5353 ルーム
chiteki	知的
imada	いまだ
saikon	再婚
soushita	そうした
joujou	上場
shuken	主権
yasui	安い
###  5361 オーバー
###  5362 サンデー
## shinkou	親交	侵攻
kojima	小島
## tsuku	着く	つく
bokushi	牧師
sueru	据える
yoritomo	頼朝
ookami	狼
## kan	菅	間
## sai	債	彩
shokan	所管
tenbou	展望
shutchou	出張
tadoru	辿る
ryuunyuu	流入
kahei	貨幣
unmei	運命
jikka	実家
## hai	肺	敗
hatan	破綻
## shoumei	照明	証明
ootani	大谷
shukkou	出航
mugen	無限
mame	豆
## yasushi	靖	康
tekitai	敵対
tenjin	天神
kaisatsuguchi	改札口
yakubutsu	薬物
## kasu	貸す	化す
koutaishi	皇太子
hachiouji	八王子
soushitsu	喪失
###  5396 アントニオ
###  5397 オート
## sendai	先代	仙台
haika	配下
juusou	重奏
nimotsu	荷物
## chuutou	中東	中等
## ku	句	区
###  5404 バスtei
## nashi	梨	無し
chokkatsu	直轄
youken	要件
###  5408 エリック
suzume	雀
zanson	残存
###  5411 サウス
###  5412 コミュニケーション
geka	外科
## tsuru	釣る	鶴
hyoudai	表題
shuukou	就航
toubatsu	討伐
funabashi	船橋
ekishou	液晶
kon	琴
## shin	審	信
## saiken	債権	再建
takagi	高木
esa	餌
###  5425 セーブ
souko	倉庫
tannaru	単なる
harada	原田
###  5429 シアター
## seimei	声明	生命
kakei	家系
###  5432 セブン
###  5433 ブッシュ
###  5434 ユー
shiiki	市域
danatsu	弾圧
###  5437 シャトル
hetsu	経つ
jokyo	除去
asahikawa	旭川
futoji	太字
suzu	鈴
shinden	神殿
yuusuu	有数
arima	有馬
manzoku	満足
juutai	渋滞
iou	硫黄
rendou	連動
denji	電磁
irei	異例
kyuukyo	急遽
###  5453 ノーベル
koubo	公募
onkyou	音響
## mitsu	蜜	密
###  5457 バブル
###  5458 マックス
yokozuna	横綱
kisou	競う
nankyoku	南極
arakajime	予め
## sakai	酒井	境
junzuru	準ずる
kansa	監査
###  5466 ペン
keshou	化粧
yoshikawa	吉川
sasageru	捧げる
kougakubu	工学部
seiatsu	制圧
buttai	物体
mokugeki	目撃
migoto	見事
###  5475 ノート
## kishi	棋士	岸
kanshou	干渉
ninshou	認証
juudai	重大
kitakami	北上
moru	漏る
###  5482 ジェイ
ginza	銀座
###  5484 バッハ
hiruma	昼間
arakawa	荒川
fumikiri	踏切
nouson	農村
###  5489 モニター
yuusei	郵政
## shoukou	商工	将校
## toru	撮る	取る
tsutsumi	堤
tataku	叩く
hikiwatasu	引き渡す
###  5496 バルブ
## chou	蝶	長
## koutou	好投	高等
saiteki	最適
sekishoku	赤色
iwau	祝う
## shirei	指令	司令
## shinsei	新生	申請
###  5504 ハリー
sayounara	さようなら
inryou	飲料
senkai	旋回
kawaguchi	川口
kiniiru	気に入る
ootsuka	大塚
###  5511 シード
###  5512 シミュレーション
dengeki	電撃
## ka	佳	科
ketsujou	欠場
###  5516 ロマン
kizai	機材
kosei	個性
###  5519 スイッチ
###  5520 パロディ
shuumei	襲名
futeiki	不定期
###  5523 フェリー
###  5524 ヘッセン
komai	細い
inui	乾
###  5527 エディ
## o	緒	尾
## denki	伝記	電気
###  5530 マリ
daichi	台地
## masu	益	増す
chakkou	着工
meimon	名門
choudo	丁度
###  5536 ロケ
kyuushutsu	救出
###  5538 アナウンス
junchou	順調
###  5540 ハーフ
bante	番手
## narabini	ならびに	並びに
shikyuu	支給
gouri	合理
kawakiri	皮切り
###  5546 センサー
###  5547 トニー
seisuu	整数
omae	御前
## sei	精	正
###  5551 ソナタ
sonogoro	その頃
chouritsu	町立
## keiou	京王	慶応
ichimon	一門
kikuchi	菊池
###  5557 ディスプレー
chuuka	中華
taihoku	台北
doboku	土木
chuusa	中佐
## kyouyou	供用	教養
chouri	調理
###  5564 ターン
###  5565 クリスチャン
###  5566 アンナ
tengoku	天国
nanbei	南米
buta	豚
fudou	不動
fuzui	付随
###  5572 アイス
iroiro	色々
###  5574 メニュー
yotou	与党
chuukyou	中京
kakueki	各駅
kouzoku	皇族
kansetsu	関節
nenjuu	年中
yatou	野党
miyauchi	宮内
###  5583 ギャグ
wahei	和平
shigan	志願
## tou	糖	党
## kouka	硬貨	効果
kuroda	黒田
jumyou	寿命
## zenshin	前進	前身
gunkan	軍艦
soui	相違
meimoku	名目
bengi	便宜
gaiyashu	外野手
seikai	政界
mizuno	水野
keikan	景観
soushi	創始
awaji	淡路
###  5601 グラウンド
shuueki	収益
honchou	本町
###  5604 ライブラリー
###  5605 ミズーリ
###  5606 ニュージャージー
tourui	盗塁
noujou	農場
zairai	在来
###  5610 メトロ
sukeru	透ける
koubutsu	鉱物
isao	勲
###  5614 バルト
## ka	過	科
## zoku	俗	族
## kousei	攻勢	構成
nyuutai	入隊
kawagoe	川越
## toku	説く	徳
tekiou	適応
makino	牧野
yasuda	安田
kyuusai	救済
###  5625 セッション
bunpou	文法
meishi	名詞
###  5628 スクリーン
karyoku	火力
###  5630 ビーム
###  5631 パシフィック
## hoshou	補償	保障
obiru	帯びる
## kamo	鴨	かも
ketsu	結
shirakawa	白河
###  5637 マリオ
## nakunaru	無くなる	亡くなる
## jikoku	自国	時刻
## ki	奇	機
kansha	感謝
kokuchi	告知
###  5643 パーセント
gensui	元帥
## sharyou	車輌	車両
tahatsu	多発
###  5647 ション
## satoshi	哲	賢
echizen	越前
izumo	出雲
## kei	啓	系
###  5652 スカイ
shuseki	首席
## kondou	混同	近藤
shiraseru	知らせる
takano	高野
###  5657 チェック
shinten	進展
shinyuu	親友
###  5660 ビートルズ
hissatsu	必殺
## seitou	正当	政党
joukuu	上空
sasebo	佐世保
shinryou	診療
haku	泊
tanomu	頼む
## kumu	汲む	組む
###  5669 ミシシッピ
###  5670 プレゼント
rakka	落下
unpan	運搬
ishida	石田
## shuseki	主席	首席
sorehodo	それほど
daen	楕円
ozawa	小沢
daiou	大王
## kouhyou	好評	公表
eikyuu	永久
roujin	老人
kubo	久保
## shisha	使者	死者
###  5684 カップリング
shazai	謝罪
###  5686 ワンマン
ikioi	勢い
tsukamu	掴む
taikyuu	耐久
danshaku	男爵
###  5691 セカンド
daimei	題名
kaigou	会合
## kankoku	勧告	韓国
shatei	射程
## toukyuu	投球	東急
shuueisha	集英社
haigo	背後
chiyo	千代
###  5700 フリゲート
## yatou	雇う	野党
###  5702 シフト
meguro	目黒
###  5704 リスナー
tashou	多少
###  5706 ルートヴィヒ
## kansen	艦船	感染
###  5708 バネ
chuujitsu	忠実
irekaeru	入れ替える
minpou	民放
mainichihousou	毎日放送
asano	浅野
kyuureki	旧暦
konpon	根本
shibata	柴田
funin	赴任
###  5718 グラフ
###  5719 ミシガン
###  5720 ウィンブルドン
kenchou	県庁
morikomu	盛り込む
shishou	師匠
## shuhou	主砲	手法
ishihara	石原
kajou	過剰
hikaru	光る
botsugo	没後
kutsu	靴
## hasshou	発祥	発症
###  5731 アプリ
nakanaka	なかなか
shubetsu	種別
## kin	禁	金
## han	伴	版
###  5736 スターリン
###  5737 プレミアム
###  5738 ダグラス
mokuzai	木材
yari	槍
###  5741 ルネサンス
nikutai	肉体
## so	疎	祖
## tora	寅	虎
taihai	大敗
###  5746 レアル
## hiku	弾く	引く
###  5748 シベリア
ekimei	駅名
hitomi	瞳
###  5751 キャッシュ
ninkan	任官
###  5753 フェラーリ
###  5754 マジック
###  5755 ペット
## on	温	恩
## igo	囲碁	以後
kuniguni	国々
shinja	信者
jousen	乗船
shigi	市議
###  5762 アーキテクチャ
## ran	欄	乱
kouhaku	紅白
###  5765 ハンス
## seifuku	制服	征服
kajitsu	果実
## ika	医科	以下
akogareru	憧れる
teijuu	定住
## shuukan	習慣	週間
## kougaku	高額	工学
###  5773 ラーメン
jisaku	自作
seireki	西暦
###  5776 ヤマハ
fudan	普段
honda	本多
shouaku	掌握
nezumi	鼠
suii	推移
furi	不利
###  5783 インディーズ
yasai	野菜
## koueki	公益	交易
## taku	拓	宅
###  5787 ドリーム
###  5788 フェア
ureru	売れる
###  5790 マーティン
## keikoku	警告	渓谷
koritsu	孤立
kyuuyou	休養
shouhei	招聘
kona	粉
waribiki	割引
gunzei	軍勢
nouchi	農地
###  5799 ナップ
###  5800 インターフェース
## kokusei	国政	国勢
## oota	大田	太田
## kan	鑑	間
## kousei	後世	構成
bibun	微分
shuutoku	習得
yakushoku	役職
###  5808 ノベル
## nin	忍	人
###  5810 アリーナ
juuten	重点
kiseki	奇跡
tsuiseki	追跡
## denki	電機	電気
toba	鳥羽
###  5816 ニコライ
shisuu	指数
###  5818 オレゴン
asai	浅い
###  5820 ホークス
guai	具合
oyako	親子
tsuyomeru	強める
chuuritsu	中立
###  5825 ブリッジ
saikutsu	採掘
###  5827 ガイド
meijin	名人
yokoyama	横山
gekitai	撃退
temae	手前
nantan	南端
## hen	偏	編
buji	無事
###  5835 ナレーション
shimonoseki	下関
kasei	火星
hasshin	発信
## akira	晃	昭
## han	斑	版
kyakushitsu	客室
afureru	溢れる
kakuryou	閣僚
kashiramoji	頭文字
## shikaku	視覚	資格
kougei	工芸
uji	宇治
rinri	倫理
tsuranuku	貫く
###  5850 グラビア
yohou	予報
sano	佐野
## shiba	柴	芝
kakureru	隠れる
shounan	湘南
haisui	排水
katagawa	片側
## kaiten	開店	回転
musashino	武蔵野
###  5860 ストーン
###  5861 アシスト
shizumu	沈む
kenbaiki	券売機
roshutsu	露出
kasetsu	仮説
###  5866 ショット
###  5867 プレス
heni	変異
ebi	海老
setsudan	切断
###  5871 フォーマット
iso	磯
###  5873 ウィルソン
subarashii	素晴らしい
hokyou	補強
###  5876 ライフル
## abe	安倍	阿部
nakagoro	中頃
shoyou	所要
sesshu	摂取
hagi	萩
###  5882 マスク
###  5883 エクスプレス
## atsushi	厚	淳
hozen	保全
###  5886 アルファベット
tensou	転送
kudarosu	下ろす
fukkyuu	復旧
chuugata	中形
nyuukyo	入居
soku	束
sharin	車輪
genshoku	現職
reisen	冷戦
kana	仮名
moushideru	申し出る
###  5898 サイン
## takeshi	たけし	武
## kawaru	替わる	変わる
boukuu	防空
## kouchi	高地	高知
zousetsu	増設
enkaku	沿革
akatsuki	暁
###  5906 ペルー
###  5907 ハイビジョン
###  5908 モール
###  5909 ヤクルト
## yougo	擁護	用語
###  5911 スパイ
haaku	把握
fusu	付す
###  5914 パンチ
chakunan	嫡男
## senkyo	占拠	選挙
kokki	国旗
saichou	最長
sougi	葬儀
## koe	肥	声
oouchi	大内
isou	位相
makaseru	任せる
seijou	正常
aikou	愛好
takeru	炊ける
kusunoki	楠
chuusen	抽選
fukameru	深める
## fu	負	府
ehon	絵本
gensan	原産
boudou	暴動
suiryoku	水力
###  5935 エントリー
doro	泥
youchi	用地
daseki	打席
shuppin	出品
## kaki	垣	書
akashi	明石
###  5942 ビクター
## nenshou	年少	燃焼
jishou	自称
## yuu	夕	優
###  5946 ライオンズ
asahishinbun	朝日新聞
chouchou	長調
kousai	交際
###  5950 アフガニスタン
###  5951 ミネソタ
###  5952 セガ
hasan	破産
michiru	満ちる
renritsu	連立
sumiyoshi	住吉
## saikou	再興	最高
hanyou	汎用
shitetsu	私鉄
kemuri	煙
shaku	尺
baka	馬鹿
okamoto	岡本
kika	幾何
keijiban	掲示板
## kurai	暗い	位
iryoku	威力
## shou	翔	賞
karu	狩る
bokan	母艦
kenjuu	拳銃
daisuke	大輔
hindo	頻度
###  5974 マイクロソフト
juunin	住人
nanjimo	何時も
riten	利点
tojou	途上
meneki	免疫
mujun	矛盾
ketsuron	結論
tsubo	坪
## taichou	体長	隊長
###  5984 ダイエー
shimada	島田
jimen	地面
ama	尼
choujin	超人
nishimura	西村
shiri	尻
touka	投下
## shinkou	新興	侵攻
###  5993 タービン
touyo	投与
###  5995 オットー
###  5996 モバイル
odakyuu	小田急
moppara	専ら
shintou	浸透
mesu	雌
## sai	差異	彩
nemuru	眠る
basha	馬車
iyo	伊予
toriatsukai	取扱
sakebu	叫ぶ
###  6007 セールス
###  6008 バーン
## datsu	奪	脱
sogai	阻害
niji	虹
haneda	羽田
kaiso	改組
shiden	市電
###  6015 レオン
ryouyou	療養
###  6017 ハーモニー
ondan	温暖
ketsueki	血液
moyoosu	催す
###  6021 ニンテンドー
###  6022 ティー
## rou	楼	労
jittai	実態
## koushin	行進	更新
## idou	異動	移動
norikumiin	乗組員
higashiyama	東山
###  6029 ブレイク
###  6030 カフェ
zureru	ずれる
shokuyou	食用
kanetsu	加熱
## kaisen	回線	海戦
kanton	広東
zenshuu	全集
shoui	少尉
mokuyou	木曜
###  6039 コンパクト
###  6040 ムハンマド
ootomo	大友
chikan	置換
tokuyuu	特有
kushi	駆使
meisho	名所
horu	掘る
## ooi	大井	多い
geigeki	迎撃
## shoukou	症候	将校
jouyousha	乗用車
## nami	浪	波
###  6052 パキスタン
###  6053 サンディエゴ
## kansou	換装	乾燥
suwaru	座る
usagi	兎
baitai	媒体
kimochi	気持ち
saijou	最上
## kageki	過激	歌劇
naha	那覇
ryouyuu	領有
hosonagai	細長い
shouka	消化
###  6065 デトロイト
nittei	日程
## honda	本田	本多
manukareru	免れる
kaketsu	可決
gattai	合体
## san	算	酸
###  6072 アルバニア
hyouga	氷河
###  6074 モーニング
ketten	欠点
## dendou	伝道	電動
chousetsu	調節
hankei	半径
kasegu	稼ぐ
heiten	閉店
hyoushiki	標識
kumagaya	熊谷
###  6083 グローバル
## koufu	公布	甲府
kyuukyuu	救急
kitte	切手
zutto	ずっと
junjo	順序
## kansetsu	間接	関節
###  6090 プリンス
nishiguchi	西口
denen	田園
inshi	因子
tansaku	探索
chuushou	中小
dojou	土壌
minji	民事
toda	戸田
rinen	理念
###  6100 パンク
###  6101 デルタ
toyohashi	豊橋
daisuu	代数
gokai	誤解
###  6105 ショック
ryougawa	両側
###  6107 プロトコル
###  6108 ムービー
engun	援軍
###  6110 ウェイ
inoru	祈る
chikau	誓う
fuchuu	府中
koga	古河
tokugi	特技
kaei	嘉永
###  6117 ムスリム
## seiyaku	製薬	制約
###  6119 ギア
###  6120 ビート
## hi	否	比
taihei	太平
yamauchi	山内
kyokutou	極東
buryoku	武力
###  6126 スティーヴン
jiyuutou	自由党
kuu	食う
doukyuusei	同級生
tachikawa	立川
mosuru	模する
marui	丸い
## koufu	交付	甲府
###  6134 ループ
keigen	軽減
###  6136 バリエーション
tokuban	特番
futoi	太い
doushi	動詞
###  6140 ドメイン
hitsuji	羊
###  6142 ホイール
## seinen	成年	青年
###  6144 オイル
shunou	首脳
sashie	挿絵
###  6147 プラザ
saha	左派
zendo	全土
###  6150 アドルフ
shinjiru	信じる
###  6152 ヒューストン
## kouka	高価	効果
juushou	重傷
## shikou	指向	施行
## kyuu	給	旧
###  6157 コーラス
###  6158 メダリスト
###  6159 フランクフルト
higeki	悲劇
chiru	散る
###  6162 ストローク
###  6163 ダーク
sadou	作動
andou	安藤
seishoku	聖職
## tenkou	天候	転向
tobasu	飛ばす
## minato	湊	港
## jitai	辞退	事態
taikan	退官
## shintou	新党	浸透
###  6173 スキル
umeda	梅田
shuryou	狩猟
###  6176 ハーバード
## kougi	広義	抗議
zenkyoku	全曲
ayumu	歩む
hyuuga	日向
###  6181 フランソワ
###  6182 デッキ
## hassha	発車	発射
kumitateru	組み立てる
komi	込
## oda	小田	織田
###  6187 シチリア
###  6188 シリンダー
###  6189 ジェフ
matsui	松井
###  6191 バンダイ
suishou	推奨
###  6193 ユニオン
keisuu	係数
utsumi	内海
###  6196 フォワード
jouji	常時
## akira	彰	昭
kaichiku	改築
###  6200 ユニホーム
###  6201 ナトリウム
nada	灘
kinko	金庫
shikisai	色彩
###  6205 プラハ
###  6206 アルミ
majan	麻雀
kufuu	工夫
###  6209 アピール
###  6210 ウエスタン
kouku	校区
###  6212 バート
houmuru	葬る
## kiri	霧	桐
###  6215 マレー
narau	倣う
somosomo	そもそも
chokuryuu	直流
## shokuryou	食糧	食料
doki	土器
idai	偉大
###  6222 ワークス
bousai	防災
suiei	水泳
## tei	低	定
shamen	斜面
###  6227 アリス
###  6228 クール
matsushita	松下
## shoutai	正体	招待
utaawase	歌合
enka	塩化
jiban	地盤
entotsu	煙突
###  6235 マット
###  6236 マンチェスター
chisso	窒素
matsubara	松原
shorui	書類
yuuzai	有罪
danzetsu	断絶
ashu	亜種
yasashii	優しい
kouon	高温
shibai	芝居
meisei	名声
## ryou	涼	量
tamokuteki	多目的
###  6249 アイヌ
fujisawa	藤沢
nouka	農家
katashiki	型式
naitou	内藤
tone	利根
fujii	藤井
katte	勝手
jinbun	人文
## taichou	体調	隊長
## yuujin	有人	友人
## horu	彫る	掘る
seinan	西南
manzai	漫才
## sai	犀	彩
shunjuu	春秋
senshuu	専修
tokuhitsu	特筆
oozumou	大相撲
youkai	妖怪
## tsuyoshi	毅	剛
hissu	必須
goukin	合金
suigen	水源
takusan	沢山
###  6274 ナポリ
hiji	肘
kyokumoku	曲目
## taikei	体形	体系
harima	播磨
bui	部位
kinniku	筋肉
uchidasu	打ち出す
hyouteki	標的
###  6283 インテル
###  6284 ケネディ
###  6285 ヴィクトリア
nyou	尿
kokuei	国営
kinsen	金銭
inchou	院長
issei	一斉
hayakawa	早川
###  6292 キエフ
## joumu	常務	乗務
###  6294 トロント
chichibu	秩父
shingeki	進撃
waga	我が
genki	元気
kusen	苦戦
## zen	禅	善
sokkin	側近
eien	永遠
###  6303 イラストレーター
shinsui	進水
ringo	林檎
shingun	進軍
gimuzukeru	義務付ける
miyoshi	三好
###  6309 オルガン
hansuu	半数
chin	珍
sazukeru	授ける
## keiki	景気	契機
###  6314 オーディオ
kourou	功労
fuzai	不在
kokuhaku	告白
oozeki	大関
hirosaki	弘前
ikkaku	一角
shuuseki	集積
###  6322 ベンチ
###  6323 アイランド
###  6324 ポンプ
tsume	爪
oujo	王女
## fuku	副	福
sakurai	桜井
kousui	降水
senkei	線形
###  6331 チケット
ketchaku	決着
###  6333 ターゲット
haeru	生える
eiri	営利
toumei	透明
shuyoku	主翼
toboshii	乏しい
tetsudau	手伝う
tensai	天才
shisai	司祭
jinchi	陣地
suruga	駿河
tsuraneru	連ねる
## tai	貸	隊
hikiwakeru	引き分ける
###  6347 トリノ
## koutei	工程	皇帝
tairyoku	体力
## seitou	正統	政党
###  6351 マスコット
###  6352 ポルノ
ikebukuro	池袋
## ou	央	王
kokorozasu	志す
kyoudan	教団
###  6357 スロバキア
doukutsu	洞窟
###  6359 カントリー
###  6360 スタンダード
###  6361 ドッグ
kurashiki	倉敷
## kura	鞍	蔵
doukou	同行
honyuu	哺乳
## katsu	克	勝つ
tokushoku	特色
chikujou	築城
###  6369 フランシス
## soutou	総統	相当
shinjitsu	真実
## shuu	収	州
## kikan	基幹	機関
chuudoku	中毒
shingai	侵害
shonichi	初日
###  6377 アップル
###  6378 モーツァルト
heichi	平地
###  6380 ダンサー
tsuda	津田
mita	三田
washi	鷲
###  6384 パレスチナ
## mata	股	又
zouei	造営
muri	無理
furumau	振る舞う
###  6389 ユニバーサル
kuwa	桑
hodou	歩道
chokuei	直営
###  6393 パチンコ
shitai	死体
###  6395 コロラド
hyouhon	標本
nakusu	亡くす
###  6398 モントリオール
keihou	刑法
semi	蝉
## rou	蝋	労
## nori	海苔	則
tomodachi	友達
gojitsu	後日
shousen	商船
fukoku	布告
miokuru	見送る
###  6408 サスペンション
kouwa	講和
rakuten	楽天
hensen	変遷
zokusei	属性
senku	先駆
nanmin	難民
## tsugu	つぐ	継ぐ
###  6416 フレデリック
tantai	単体
tanin	他人
###  6419 リアル
henkyou	辺境
wangan	湾岸
## nani	難易	何
tekigou	適合
tankou	炭坑
###  6425 ソフトバンク
###  6426 ラッセル
mokusei	木製
kouhai	後輩
kourai	高麗
yuukensha	有権者
sokuryou	測量
## kuma	隈	熊
kyozetsu	拒絶
###  6434 ハンター
###  6435 ドラゴンズ
## seikai	正解	政界
toua	東亜
## kansei	管制	完成
noridasu	乗り出す
## izumi	和泉	泉
imagawa	今川
oushitsu	王室
shokudou	食堂
## ita	至	板
mo	喪
machida	町田
seizen	生前
###  6448 ジョセフ
kippu	切符
misao	操
kanbou	官房
ouke	王家
kinchou	緊張
hanabi	花火
###  6455 アイスランド
shihatsu	始発
kyoukan	教官
kuzukago	葛籠
## jiten	辞典	時点
gunbu	軍部
hamada	浜田
hanmen	反面
## taisha	代謝	退社
gaiden	外伝
shukke	出家
## kouchou	好調	校長
imai	今井
gouka	豪華
## kaisou	階層	改装
###  6470 オリックス
ooe	大江
## saikai	再会	再開
## genshi	原始	原子
chikuseki	蓄積
nougaku	農学
boudai	膨大
###  6477 ライオン
shosetsu	諸説
## tame	ため	為
shimotsuke	下野
###  6481 バイト
haisu	配す
jouban	常磐
gousuru	号する
ryokan	旅館
###  6486 ルノー
seken	世間
###  6488 シネマ
satake	佐竹
###  6490 セントルイス
fuzen	不全
###  6492 コラボレーション
mukankei	無関係
majo	魔女
ishigaki	石垣
## chuui	中尉	注意
jougen	上限
genpatsu	原発
tashika	確か
shokou	諸侯
bakuha	爆破
shiroishi	白石
yoron	世論
aisatsu	挨拶
## saku	咲く	作
kuzusu	崩す
inbou	陰謀
dakkan	奪還
###  6509 ボランティア
zoukan	増刊
betsubetsu	別々
takashima	高島
## tsutomu	勤	務
taihou	大砲
masani	正に
## kaisou	回想	改装
###  6517 ガリシア
###  6518 キット
kyouryuu	恐竜
kakari	掛
## aki	安芸	秋
## enki	塩基	延期
###  6523 ゴジラ
## saikai	西海	再開
imyou	異名
###  6526 シニア
###  6527 エレクトリック
choushuu	徴収
jichou	次長
miyamoto	宮本
shushi	種子
byoushi	病死
ougi	扇
## taiyou	大洋	太陽
migite	右手
kaoku	家屋
###  6537 ラップ
###  6538 アムステルダム
gikyoku	戯曲
nichiji	日時
## kiso	木曽	基礎
awa	阿波
## tsuku	突く	つく
jiritsu	自立
sekibun	積分
tokken	特権
douseiai	同性愛
###  6548 インストール
mohaya	もはや
###  6550 ホラー
###  6551 ドール
furuu	振るう
## byou	廟	秒
shinkuu	真空
tsuikyuu	追求
###  6556 クイーン
youki	容器
## chou	調	長
taigan	対岸
###  6560 リトル
shouji	商事
chien	遅延
kaoru	薫
## haru	貼る	春
kuwaete	加えて
###  6566 ローン
sesshou	摂政
###  6568 フィルター
jitsuni	実に
endou	遠藤
## you	庸	よう
honshitsu	本質
koushuu	講習
## kyoudo	郷土	強度
## sho	諸	署
###  6576 インディ
suimen	水面
bosshuu	没収
kizou	寄贈
jisshou	実証
nantoka	何とか
###  6582 ホスト
## koushuu	公衆	講習
## suu	吸う	崇
keisoku	計測
## taku	炊く	宅
daikan	代官
## kore	是	これ
suikou	遂行
warabe	童
kokutai	国体
###  6592 ガーデン
nishinomiya	西宮
## osameru	修める	収める
naisou	内装
kenka	喧嘩
fumaeru	踏まえる
chokuretsu	直列
###  6599 グッズ
ryouji	領事
## katei	仮定	家庭
kyuukan	休刊
senka	戦果
ja	じゃ
nusumu	盗む
amai	甘い
yakuzai	薬剤
houshuu	報酬
doumyaku	動脈
higashiguchi	東口
## shouten	焦点	商店
sosen	祖先
###  6613 マウント
###  6614 ファミコン
sumi	炭
sekki	石器
jitsumu	実務
setagaya	世田谷
mitsugu	貢
koumuru	被る
## fujin	婦人	夫人
chitsujo	秩序
taigaku	退学
hato	鳩
## ka	果	科
shii	椎
###  6627 ギャラリー
shitashii	親しい
###  6629 テイラー
ryuuha	流派
tanba	丹波
## haku	吐く	泊
nintendou	任天堂
konyaku	婚約
tahou	他方
## kakari	係	掛
baibai	売買
kinsetsu	近接
ryakudatsu	略奪
###  6640 デバイス
###  6641 アイオワ
###  6642 タイミング
kekkan	血管
renpai	連敗
aikoku	愛国
mansei	慢性
gengaku	弦楽
nakahara	中原
handoutai	半導体
shonendo	初年度
gake	崖
## sumi	墨	炭
kouhani	広範囲
kasan	加算
shitatameru	したためる
kigu	危惧
totonoeru	整える
###  6658 エンド
###  6659 セキュリティ
###  6660 ハンドル
## bou	帽	房
## kaitou	解答	回答
## kyuushi	急死	休止
## kouan	公安	考案
ichigyou	一行
konzatsu	混雑
## shuyou	腫瘍	主要
## seiri	生理	整理
itsuwa	逸話
ganrai	元来
moyori	最寄り
kokuhatsu	告発
###  6673 プラスチック
tanpatsu	単発
gosho	御所
buin	部員
chouin	調印
## shokan	書簡	所管
yokkaichi	四日市
maebashi	前橋
shikkyaku	失脚
shomin	庶民
###  6683 イヤー
genkin	現金
hikiukeru	引き受ける
###  6686 ナイター
###  6687 ニュータウン
hibiku	響く
junban	順番
rigaku	理学
senritsu	旋律
oyagaisha	親会社
###  6693 ゲリラ
nakada	中田
uchida	内田
igi	意義
heigen	平原
###  6698 アレクサンダー
unsou	運送
## genkou	原稿	現行
kenmu	兼務
chuumon	注文
danyuu	男優
hige	髭
## ishi	意志	石
## kai	塊	回
shikiten	式典
hidaka	日高
sanshutsu	産出
###  6710 デー
## kyou	協	教
## sei	せい	正
###  6713 ストップ
atari	辺り
###  6715 ジェリー
###  6716 フォーミュラ
settsu	摂津
## joukou	条項	乗降
###  6719 インディアナ
kezuru	削る
tasai	多彩
kachiku	家畜
gensou	幻想
minpei	民兵
###  6725 シルバー
###  6726 ステレオ
yakuhin	薬品
tsuujiru	通じる
## seiryoku	精力	勢力
## umu	有無	生む
## kotai	固体	個体
genbaku	原爆
## osameru	納める	収める
shouyou	商用
tsuukoku	通告
###  6736 アリゾナ
###  6737 オックスフォード
ukabu	浮かぶ
mau	舞う
yotte	よって
## bunka	分化	文化
matsuo	松尾
saihatsu	再発
tensha	転写
nanba	難波
daseru	出せる
enkei	円形
toshiyori	年寄り
###  6749 ベリー
onnanoko	女の子
shiawase	幸せ
dewa	出羽
mosaku	模索
kouno	河野
taiseki	堆積
## saitou	斉藤	斎藤
shishi	獅子
## atsushi	篤	淳
###  6759 ビリー
iga	伊賀
honbun	本文
###  6762 ヨーゼフ
###  6763 ビタミン
## kaitei	改定	改訂
## yousu	要す	様子
tsuigeki	追撃
###  6767 グラント
akirameru	諦める
ooishi	大石
chouhei	徴兵
###  6771 ハミルトン
## kame	瓶	亀
shisatsu	視察
tsushima	対馬
shinzen	親善
###  6776 ガール
###  6777 バット
saisen	再選
## karu	刈る	狩る
###  6780 フェルディナンド
###  6781 ハーン
suguru	卓
nanka	南下
kouten	交点
senrei	洗礼
## aka	亜科	赤
###  6787 レット
shirizokeru	退ける
## ikou	遺構	以降
yogen	予言
kenji	検事
###  6792 エルサレム
gekika	激化
moeru	燃える
kuguru	くぐる
## nai	ない	無い
fusawashii	相応しい
## kakeru	賭ける	掛ける
###  6799 シアトル
###  6800 アラスカ
uku	浮く
issetsu	一説
soroeru	揃える
ayatsuru	操る
###  6805 アルファ
###  6806 アプローチ
## tsubo	壺	坪
hoiku	保育
inan	以南
###  6810 ロール
sobo	祖母
kaji	舵
teitaku	邸宅
donoyouni	どのように
sosei	組成
###  6816 バッテリー
###  6817 ルイジアナ
###  6818 パナマ
kama	窯
suiyou	水曜
ichimen	一面
chuukai	仲介
senaka	背中
haiiro	灰色
###  6825 グレイ
shuzoku	種族
###  6827 フォーラム
youmyou	幼名
mokuyoubi	木曜日
housei	法制
jinjou	尋常
hitojichi	人質
jissha	実写
###  6834 ドラマー
yakuba	役場
## kiru	斬る	着る
houchi	放置
## utsuru	写る	移る
###  6839 コミューン
keiko	稽古
renga	煉瓦
###  6842 チェコスロバキア
###  6843 ノースカロライナ
###  6844 サンクトペテルブルク
###  6845 スペクトル
## kouen	後援	公園
asakura	朝倉
shuujitsu	終日
tsuiyasu	費やす
###  6850 リース
## kasu	課す	化す
mayaku	麻薬
moreru	漏れる
sekigahara	関ヶ原
omoshiroi	面白い
## shukkou	出港	出航
## tai	他意	隊
###  6858 ワイルド
ichizuke	位置付
koubou	工房
## shikou	志向	施行
maro	麻呂
###  6863 セダン
akasaka	赤坂
###  6865 マーシャルshotou
###  6866 ウィル
###  6867 エチオピア
souke	宗家
###  6869 レバー
kijuu	機銃
###  6871 ウラン
chuuzou	鋳造
taigai	対外
seibatsu	征伐
## tsukuba	つくば	筑波
makushita	幕下
###  6877 ハル
bousou	暴走
## e	得	絵
chuuzai	駐在
ekiden	駅伝
## shoushuu	召集	招集
ichinomiya	一宮
seirei	政令
###  6885 シャツ
seiiku	生育
## kyuusei	旧姓	旧制
###  6888 ケンブリッジ
## koushi	公使	講師
shitamawaru	下回る
## daichi	大地	台地
touketsu	凍結
## kisei	寄生	規制
tanabe	田辺
asou	麻生
ochitsuku	落ち着く
## shisetsu	使節	施設
ichiyaku	一躍
kigeki	喜劇
## zenbu	前部	全部
jogen	助言
## kanshou	鑑賞	干渉
otoroeru	衰える
###  6904 フランシスコ
###  6905 エンジニア
###  6906 エルンスト
fujuubun	不十分
ketsudan	決断
bosatsu	菩薩
tanshi	端子
zokkou	続行
suiden	水田
## shuukai	周回	集会
teitoku	提督
## kama	蒲	窯
## soku	測	束
suzuka	鈴鹿
## kaoru	薫る	薫
donna	どんな
###  6920 ノット
###  6921 ペルシア
## youin	要員	要因
## go	碁	語
## taiki	待機	大気
honke	本家
###  6926 アンドレ
isshin	一新
chisui	治水
sashikaeru	差し替える
uragiru	裏切る
## shushi	趣旨	種子
ago	顎
tenraku	転落
wamei	和名
## kita	喜多	北
nyuukai	入会
###  6937 パレード
shukujitsu	祝日
maizuru	舞鶴
juushin	重臣
###  6941 アンダーソン
###  6942 マウス
kyojou	居城
yamate	山手
###  6945 ユリウス
yoyuu	余裕
## koushou	工廠	交渉
## geki	隙	劇
majutsu	魔術
shitchi	湿地
majieru	交える
## yuusei	優勢	郵政
## douki	動機	同期
###  6954 スーツ
jushi	樹脂
honganji	本願寺
shintaku	信託
oginau	補う
tsurumi	鶴見
niwatori	鶏
akiyama	秋山
## kakeru	欠ける	掛ける
## touji	当事	当時
###  6964 リュー
yayoi	弥生
## kaishuu	改宗	改修
souryo	僧侶
kanshuu	慣習
gekigen	激減
## shinzou	新造	心臓
shinto	信徒
ninja	忍者
###  6973 スロベニア
###  6974 スケジュール
## kongou	金剛	混合
## kama	釜	窯
isetsu	移設
ouzoku	王族
ryuuchi	留置
yano	矢野
## toukyuu	等級	東急
kamigami	神々
kaneko	金子
tokiori	時折
###  6985 レート
tenohira	手の平
rokuga	録画
torii	鳥居
###  6989 ゲオルク
hakuchou	白鳥
shomotsu	書物
saeki	佐伯
###  6993 エフエム
taitei	大抵
suisou	吹奏
menjo	免除
## kaku	掻く	角
###  6998 サポーター
shuuyaku	集約
###  7000 バーデン
sode	袖
###  7002 ロベルト
## shidou	始動	指導
ikenai	いけない
goraku	娯楽
seijuku	成熟
fukusei	複製
kouriyama	郡山
###  7009 フラン
###  7010 ワルシャワ
koumin	公民
joukin	常勤
###  7013 フォース
## kyuu	級	旧
## fuji	不二	藤
nigiwau	賑わう
okasu	犯す
## shita	舌	下
tamagawa	玉川
jouzou	醸造
###  7021 ハドソン
###  7022 トリオ
zahyou	座標
jinkaku	人格
oomori	大森
## hi	秘	比
nagori	名残り
fuusa	封鎖
###  7029 ダンジョン
###  7030 アルミニウム
## shidou	市道	指導
## mokusei	木星	木製
murata	村田
kaigo	介護
tanchou	短調
retsusuru	列する
###  7037 ムーア
###  7038 フランクリン
wareru	割れる
maniau	間に合う
yuuchi	誘致
zousei	造成
tokurei	特例
seitetsu	製鉄
irekawaru	入れ替わる
## souzou	想像	創造
## shadan	遮断	社団
###  7048 サンタ
shihyou	指標
sogeki	狙撃
###  7051 シンプル
###  7052 バルカン
## kouso	控訴	酵素
keizu	系図
senzo	先祖
kachime	勝ち目
## kaimei	解明	改名
joseki	除籍
nounyuu	納入
joujun	上旬
ryoutan	両端
ihoku	以北
## sanchi	産地	山地
kuzureru	崩れる
kazei	課税
taiko	太鼓
dantou	弾頭
## kaki	火器	書
###  7069 コロムビア
tomita	富田
junkai	巡回
hataage	旗揚げ
kisen	汽船
###  7074 カレー
hakusan	白山
sousuu	総数
gairai	外来
hokutan	北端
yuruyaka	緩やか
###  7080 カスティーリャ
missetsu	密接
imiai	意味合い
mochikabu	持ち株
###  7084 クライアント
jizoku	持続
###  7086 ローレンス
###  7087 アルメニア
tennouji	天王寺
saikouhou	最高峰
## osu	推す	雄
fuchou	不調
oriru	降りる
kusshi	屈指
arai	新井
###  7095 アウグスト
###  7096 タイムズ
###  7097 ナムコ
youji	幼児
kagu	家具
kyoushoku	教職
sousou	曹操
###  7102 ゴシック
###  7103 ジョニー
## nagai	永井	長い
###  7105 リアルタイム
beppu	別府
chokurei	勅令
awasete	合わせて
###  7109 グルジア
###  7110 カウンター
###  7111 カタログ
###  7112 ヤンキース
meiwa	明和
tenshin	天津
risu	りす
###  7116 カンボジア
###  7117 ツイン
###  7118 フアン
###  7119 ビルマ
## shuuketsu	集結	終結
aoiro	青色
ishibashi	石橋
aeru	会える
kitsuen	喫煙
## kyuusei	急性	旧制
saisoku	最速
genryuu	源流
## kanshuu	監修	慣習
surudoi	鋭い
###  7130 ポケット
## jittai	実体	実態
chuuryuu	駐留
###  7133 アルプス
###  7134 ノーフォーク
giwaku	疑惑
haki	破棄
tsuuchi	通知
## yuuki	勇気	有機
###  7139 クリーク
gogaku	語学
tenka	添加
## iki	息	域
###  7143 ライナー
toshima	豊島
totsujo	突如
subayai	素早い
jogai	除外
###  7148 カンファレンス
matsuura	松浦
ippai	一杯
## haisu	廃す	配す
touzuru	投ずる
minamiguchi	南口
sone	曽根
tekkai	撤回
###  7156 ハンブルク
###  7157 タイアップ
###  7158 ルドルフ
hason	破損
###  7160 アレン
###  7161 メリット
yokin	預金
gyorui	魚類
## kouhai	荒廃	後輩
## bou	謀	房
shochi	処置
souten	装填
###  7168 アルバイト
## taki	多岐	滝
taisetsu	大切
###  7171 テクノロジー
mazushii	貧しい
manryou	満了
fukyou	不況
dansou	断層
###  7176 リック
kitaguchi	北口
namari	鉛
sawagu	騒ぐ
kizokuin	貴族院
kushiro	釧路
###  7182 ウラジーミル
yokujou	浴場
## nen	念	年
genrou	元老
koushoku	公職
oitachi	生い立ち
seishi	製紙
seikyo	逝去
## shinchou	清朝	身長
## aku	空く	悪
sanin	山陰
tanoshii	楽しい
ido	井戸
hanron	反論
###  7196 アーチ
yuushi	融資
fuuzoku	風俗
yagai	野外
###  7200 グスタフ
warini	割に
kouri	小売り
## doukou	動向	同行
chingin	賃金
seishounen	青少年
## saishou	宰相	最小
kakushuno	各種の
###  7208 ウォーター
###  7209 ファイト
hokkyoku	北極
karafuto	樺太
edogawa	江戸川
## kakawaru	拘る	係わる
## ono	斧	小野
isshoku	一色
## mai	毎	舞
## yuuki	結城	有機
buke	武家
shigaku	史学
kanau	叶う
###  7221 コナミ
## iu	いう	言う
kinjiru	禁じる
kengaku	見学
osamaru	収まる
###  7226 テレビジョン
###  7227 サロン
nodo	喉
senkyoushi	宣教師
yakunin	役人
###  7231 ヨーク
###  7232 ランダム
## kouri	行李	小売り
ibo	異母
hongou	本郷
shindai	寝台
itamu	痛む
imadani	いまだに
## mura	邑	村
fuuin	封印
## seitai	生体	生態
shizuka	静か
## fun	糞	分
###  7244 フロア
yuukai	誘拐
###  7246 トライアル
###  7247 バーグ
hikitoru	引き取る
###  7249 スタン
## fuka	負荷	付加
## kou	国府	公
## kyoukou	恐慌	教皇
akiba	秋葉
genkan	玄関
## taisha	大社	退社
wara	藁
## hankyuu	半球	阪急
kirai	機雷
kahansuu	過半数
takaoka	高岡
###  7261 ハワード
###  7262 フラッシュ
tagai	互い
## michi	未知	道
chakushi	嫡子
maruyama	丸山
hokudai	北大
aoba	青葉
shinro	進路
kinpen	近辺
eishou	英称
shakkin	借金
meiki	明記
hirose	広瀬
hidarite	左手
## shushou	主将	首相
## seijin	聖人	成人
yagura	矢倉
rachi	拉致
## tenka	天下	添加
sonkei	尊敬
nyuutou	入党
## izen	依然	以前
ryokyakki	旅客機
## nobiru	延びる	伸びる
ichirei	一例
torikesu	取り消す
###  7288 エッセー
junkyo	準拠
nishikawa	西川
###  7291 アダム
###  7292 ノード
yaritori	遣り取り
tenou	天王
iyoku	意欲
shiageru	仕上げる
teibou	堤防
## oushuu	奥州	欧州
###  7299 ブラザーズ
nyuusen	入線
jikuu	時空
tsubu	粒
rinkai	臨海
## go	誤	語
shuukaku	収穫
chuusuu	中枢
touha	党派
tazuneru	訪ねる
## nasu	那須	成す
## toudai	灯台	東大
## kyougi	狭義	競技
###  7312 アパート
santou	山東
jihen	事変
jintai	人体
yureru	揺れる
## narau	習う	倣う
shutsujin	出陣
saigou	西郷
###  7320 ポスター
issou	一層
shige	しげ
ryuusan	硫酸
## kantei	鑑定	艦艇
bundan	分断
## shikou	思考	施行
choushi	調子
shinnin	信任
tadoritsuku	辿り着く
taikyaku	退却
kessaku	傑作
###  7332 ソロモンshotou
daigo	醍醐
soeru	添える
## sasu	差す	指す
###  7336 ボイス
## kawara	瓦	河原
jijo	次女
jimaku	字幕
###  7340 プライベート
## kumo	蜘蛛	雲
## kasa	傘	笠
kakyou	架橋
morita	森田
kiyaku	規約
choujou	頂上
inari	稲荷
noto	能登
kyousu	興す
###  7350 ルーキー
kimyou	奇妙
kuritsu	区立
kosenkyou	跨線橋
kayaku	火薬
###  7355 プロペラ
tsunoru	募る
## tabi	たび	旅
###  7358 アルバート
## houei	宝永	放映
###  7360 チェロ
###  7361 チーフ
amagasaki	尼崎
###  7363 リバウンド
mushou	無償
###  7365 ハンド
###  7366 フォント
kinkai	近海
###  7368 スピン
isha	医者
## sankaku	参画	三角
azuma	吾妻
teigen	低減
fuzan	釜山
asuka	飛鳥
###  7375 キネマ
chinju	鎮守
gyakutai	虐待
oomura	大村
## kitou	帰投	気筒
###  7380 ワーナー
yakume	役目
chokketsu	直結
###  7383 フェニックス
kurume	久留米
okuridasu	送り出す
###  7386 グラス
todokeru	届ける
## yameru	辞める	止める
ukai	迂回
ankoku	暗黒
maisuu	枚数
## jiki	次期	時期
ronzuru	論ずる
washa	話者
kaitoru	買い取る
## kyouyou	共用	教養
###  7397 ベネズエラ
senkoku	宣告
tsuitou	追悼
tsubaki	椿
###  7401 ワゴン
sagi	詐欺
## i	胃	井
###  7404 バンクーバー
yatsushiro	八代
shoujuu	小銃
###  7407 クリーム
ritsuan	立案
shouen	荘園
megane	眼鏡
## suishin	水深	推進
naiyashu	内野手
## jikken	実権	実験
kaiha	会派
juunan	柔軟
nagao	長尾
## kanchou	館長	艦長
sekkai	石灰
matomaru	纏まる
houshi	胞子
tansui	淡水
###  7422 アポロ
jogakkou	女学校
iwasaki	岩崎
zoushoku	増殖
fukushuu	復讐
gekido	激怒
chuushutsu	抽出
## fuka	不可	付加
myaku	脈
byoudou	平等
dohyou	土俵
tsuranaru	連なる
hokuou	北欧
nanno	何の
###  7436 フェザー
shizoku	氏族
kitano	北野
###  7439 フルート
###  7440 テリー
kuge	公家
###  7442 コラム
jisu	辞す
futokoro	懐
tenzai	点在
koushitsu	皇室
kikoeru	聞こえる
## ashi	芦	足
###  7449 ルーズベルト
hirata	平田
deiri	出入り
honmono	本物
houseki	宝石
shichuu	市中
heiretsu	並列
## chouchou	町長	長調
###  7457 マツダ
###  7458 ベテラン
kenmin	県民
shino	篠
shinzoku	親族
###  7462 ドクター
tarasu	垂らす
taikoku	大国
houseidai	法政大
riben	利便
## shintou	神道	浸透
kago	籠
###  7469 ケベック
###  7470 ボヘミア
sanji	参事
###  7472 アルト
bunke	分家
kangei	歓迎
uha	右派
###  7476 ハプスブルク
rikken	立憲
maneru	真似る
adachi	足立
###  7480 ディフェンス
yuufuku	裕福
yuri	百合
saishu	採取
## kaihen	改変	改編
kahen	可変
gunsei	軍政
itsu	いつ
###  7488 シューティング
###  7489 ケータイ
hayakukara	早くから
mureru	群れる
buyou	舞踊
###  7493 クラッシュ
hoshoku	捕食
nyuukoku	入国
konin	婚姻
kiin	起因
samatageru	妨げる
kobamu	拒む
sesshuu	接収
## shima	志摩	島
## hyoushi	拍子	表紙
teppai	撤廃
zoukei	造形
## ryou	猟	量
###  7506 グローブ
yuen	所縁
bunpitsu	分泌
hakudatsu	剥奪
###  7510 テナント
###  7511 ベルク
###  7512 バロック
## kigu	器具	危惧
kyuuzou	急増
###  7515 コイン
###  7516 アタック
###  7517 サミュエル
takeuchi	竹内
shitsugyou	失業
ube	宇部
mimei	未明
honzon	本尊
igai	以外
###  7524 ジャンクション
###  7525 バンコク
###  7526 レポート
## koushuu	広州	講習
muzai	無罪
###  7529 オファー
## chuushou	抽象	中小
houkatsu	包括
shouni	小児
###  7533 モロッコ
boukou	暴行
## atsushi	敦	淳
hossa	発作
## kyoutei	競艇	協定
## shiki	四季	式
takkyuu	卓球
shizai	資材
###  7541 カウント
## kousei	公正	構成
###  7543 マンハッタン
###  7544 スクウェア
motoko	素子
izoku	遺族
###  7547 レビュー
hensoku	変速
###  7549 グラム
###  7550 マイアミ
himo	紐
## shisei	市制	姿勢
chuuko	中古
kinoshita	木下
tsuuhou	通報
###  7556 ヘルマン
hadaka	裸
zaibatsu	財閥
## noru	載る	乗る
kawamura	川村
oba	伯母
murayama	村山
hateru	果てる
wazurau	患う
###  7565 リクエスト
habatsu	派閥
###  7567 ヨハネ
myouji	名字
## kichou	基調	貴重
choushu	聴取
###  7571 スラヴ
###  7572 ヴァージョン
shuusoku	収束
keihi	経費
tansan	炭酸
kaibou	解剖
jumoku	樹木
## kousen	光線	交戦
kaden	家電
haimen	背面
gaisen	凱旋
###  7582 リミックス
###  7583 ジミー
channeru	ちゃんねる
## kan	勘	間
###  7586 ピッチ
yasunaga	安永
## minpou	民法	民放
ritsuryou	律令
youhin	用品
ryuusei	隆盛
###  7592 コソボ
shukketsu	出血
## chou	腸	長
tsurai	辛い
kinu	絹
shinpai	心配
###  7598 レオポルト
bunkou	分校
katamuku	傾く
###  7601 ガールズ
###  7602 コーポレーション
aya	綾
hida	飛騨
jutaku	受託
goutou	強盗
tezuka	手塚
heitan	平坦
###  7609 トミー
###  7610 ミッド
seimitsu	精密
## shoushitsu	消失	焼失
jinmei	人名
minyou	民謡
juyoni	従四位
shinkyoku	新曲
shuuen	終焉
## soukan	総監	創刊
## kamo	加茂	かも
###  7620 ジェファーソン
###  7621 ウルフ
honsho	本書
###  7623 ワーク
hoshino	星野
kyuuyo	給与
seibo	聖母
kinenbi	記念日
sentakushi	選択肢
uroko	鱗
matsue	松江
## boushi	帽子	防止
honzan	本山
###  7633 スルターン
mumei	無名
## osameru	治める	収める
kajin	歌人
###  7637 コマーシャル
doutoku	道徳
###  7639 ホット
keifu	系譜
taikaku	体格
shuppei	出兵
shoukaiseki	蒋介石
## nozoku	覗く	除く
hodonaku	程無く
###  7646 レイアウト
###  7647 サマー
###  7648 アーム
senretsu	戦列
kissa	喫茶
saikousai	最高裁
chourou	長老
ritou	離党
###  7654 カーネル
kyuurai	旧来
## shinnyuu	進入	侵入
###  7657 カヴァー
###  7658 パーソナル
## isu	いすゞ	椅子
tanigawa	谷川
hakkan	発刊
omoide	思い出
###  7663 クラリネット
###  7664 ニューオーリンズ
## kaku	閣	角
## neru	練る	寝る
###  7667 ヴュルテンベルク
###  7668 パケット
hankou	犯行
kousatsu	考察
###  7671 パトリック
tousha	当社
koyaku	子役
hikoushiki	非公式
kanshoku	官職
horo	幌
###  7677 オペレーティングシステム
###  7678 マスト
## ryou	了	量
hachou	波長
###  7681 クリーブランド
###  7682 ケリー
daiyou	代用
houzuru	報ずる
###  7685 ロータリー
## kayou	火曜	通う
###  7687 マーケティング
fuhou	不法
wakugumi	枠組み
yakou	夜行
shinogu	凌ぐ
kokkaku	骨格
###  7693 フォックス
###  7694 ベストセラー
###  7695 ペンネーム
yagi	八木
## taisa	大差	大佐
ozaki	尾崎
## senjutsu	先述	戦術
heitei	平定
sewa	世話
joryuu	女流
###  7703 マイナーチェンジ
kitsune	狐
## bou	望	房
shusse	出世
jinushi	地主
###  7708 ゴミ
oin	お陰
takuchi	宅地
segawa	瀬川
## shirakawa	白川	白河
###  7713 カート
youko	陽子
kaketsukeru	駆け付ける
## seishi	静止	製紙
###  7717 ディー
shikyoku	支局
kyuuka	休暇
###  7720 トランペット
hiyaku	飛躍
okina	翁
shiya	視野
hojuu	補充
taiga	大河
shutten	出典
shuunou	収納
###  7728 リボン
ikani	如何に
## aoi	葵	青い
tensuu	点数
tsuyama	津山
yonago	米子
bougo	防護
gakufu	楽譜
## shoukai	商会	紹介
ookawa	大川
saiaku	最悪
###  7739 アルフ
kiryuu	桐生
sankan	山間
takumi	巧み
###  7743 レバノン
hisoka	密か
###  7745 パイオニア
###  7746 フォーム
okugai	屋外
torinozoku	取り除く
hikidasu	引き出す
tsuu	痛
###  7751 メリーランド
## kougyou	鉱業	工業
## kinen	近縁	記念
yasen	野戦
jikai	次回
daigakusei	大学生
youbi	曜日
furusu	古巣
inaka	田舎
## makoto	眞	真
hiromeru	広める
###  7762 パンタグラフ
###  7763 ベートーヴェン
## keihou	警報	刑法
## tousou	逃走	闘争
uso	嘘
korai	古来
suku	好く
hattori	服部
jouetsu	上越
denshin	電信
## tachibana	立花	橘
## joukou	上皇	乗降
## kou	廣	公
## te	以って	手
itami	伊丹
jounin	常任
###  7778 ポケットモンスター
###  7779 ドライ
otaru	小樽
###  7781 クルーズ
douchuu	道中
sunzen	寸前
## kon	婚	琴
sousei	早世
joumon	縄文
giji	議事
sara	皿
###  7789 ボイラー
tajuu	多重
engei	園芸
###  7792 ダラス
###  7793 アレックス
tsuuwa	通話
kanayama	金山
masatsu	摩擦
tanchi	探知
enban	円盤
daitou	大東
sadaka	定か
toshiue	年上
miyake	三宅
ukiyo	浮き世
###  7804 ジャーナル
## ei	泳	英
chuuken	中堅
taiwa	対話
hayakumo	早くも
toyokawa	豊川
pai	牌
## enki	延喜	延期
gassaku	合作
taibetsu	大別
###  7814 ウズベキスタン
## jou	情	条
chisai	地裁
kokumotsu	穀物
tagaku	多額
###  7819 ルーツ
## koushi	格子	講師
tahara	田原
###  7822 グラン
busuu	部数
haibun	配分
## shougaku	奨学	小学
###  7826 スマートフォン
###  7827 パナソニック
jika	自家
## koushiki	硬式	公式
mazeru	混ぜる
## tomo	供	友
###  7832 リプレイ
###  7833 セルフ
###  7834 オークランド
## yoru	選る	夜
hatoyama	鳩山
shutsudai	出題
## kei	圭	系
hahakata	母方
## kaikou	開港	開校
kayoubi	火曜日
renka	廉価
jouheki	城壁
hijun	批准
###  7845 シェル
###  7846 フェルナンド
###  7847 ルクセンブルク
tanoshimeru	楽しめる
kinji	近似
shashou	車掌
###  7851 フィレンツェ
yawarakai	柔らかい
bukatsu	部活
###  7854 ロジャー
reinen	例年
heiin	兵員
sagan	左岸
## kouzoku	後続	皇族
###  7859 プリンセス
###  7860 アリー
###  7861 ドナルド
ibutsu	遺物
moriagaru	盛り上がる
###  7864 スタメン
kyousuru	供する
nenchou	年長
sanpai	参拝
kiba	牙
## saishin	祭神	最新
wakamatsu	若松
kokushoku	黒色
bansou	伴奏
## yuu	悠	優
###  7874 テロップ
###  7875 ウインドー
###  7876 コネチカット
###  7877 サウスカロライナ
## teki	的	敵
tesuu	手数
gouhou	合法
ryokuchi	緑地
tokki	突起
nennen	年々
shimousa	下総
heieki	兵役
daidou	大同
torikowasu	取り壊す
satoru	悟る
suibun	水分
###  7890 ハイブリッド
## hatsugen	発現	発言
toei	都営
## gan	願	癌
souon	騒音
kakyoku	歌曲
migigishi	右岸
naname	斜め
danpen	断片
hachirou	八郎
haikou	廃校
aimatsu	相俟つ
sokoku	祖国
amoku	亜目
## rei	齢	例
chakunin	着任
###  7906 ユネスコ
senki	戦記
shisho	支所
shinmachi	新町
bujutsu	武術
tokusetsu	特設
ruikei	累計
sanran	産卵
###  7914 アラバマ
suruto	すると
###  7916 ペドロ
kaiban	改番
genkaku	厳格
tsuyomaru	強まる
###  7920 ヒュー
engo	援護
shasatsu	射殺
shiin	子音
###  7924 ホームズ
###  7925 マニラ
kaiun	海運
## kudou	工藤	駆動
outou	応答
houfuku	報復
## ai	藍	愛
junrei	巡礼
## heishi	平氏	兵士
## jishou	事象	自称
shojo	処女
bakudai	莫大
suiyoubi	水曜日
bunpai	分配
kansan	換算
## taisaku	大作	対策
tariru	足りる
seou	背負う
mitchaku	密着
###  7943 ホルン
###  7944 ケルン
## kaki	柿	書
###  7946 リーズ
tokeru	溶ける
senmu	専務
###  7949 エージェント
###  7950 エンタープライズ
###  7951 クリントン
###  7952 カリブumi
hokui	北緯
## shoki	書紀	初期
ikanaru	いかなる
kouatsu	高圧
hagaki	葉書き
###  7958 ピッツバーグ
heike	平家
taiguu	待遇
tokidoki	時々
furukawa	古川
###  7963 ドック
sagamihara	相模原
kurou	苦労
todaeru	途絶える
inseki	隕石
tobidasu	飛び出す
hansu	反す
hougyo	崩御
hada	肌
fuuzuru	封ずる
kyokusho	局所
kameyama	亀山
###  7975 ネパール
minoru	稔
shobatsu	処罰
###  7978 レーサー
## furu	孵る	振る
shutsudou	出動
azukeru	預ける
## shin	辛	信
## fusai	負債	夫妻
azuchi	安土
akou	赤穂
###  7986 カラオケ
kishin	寄進
junshou	准将
guchi	愚痴
###  7990 スライド
hosou	舗装
## shijou	誌上	市場
## keikan	警官	景観
###  7994 ニコニコ
###  7995 ディア
kougoni	交互に
bijin	美人
kyoutai	筐体
## koufuku	幸福	降伏
###  8000 アルジェリア
## enkaku	遠隔	沿革
medo	目処
###  8003 マーガレット
## teiji	定時	提示
otome	乙女
sekisai	積載
###  8007 マイン
###  8008 コンゴminshukyouwakoku
nerima	練馬
monomane	物真似
shuzou	酒造
hatakeyama	畠山
###  8013 マクロス
jouren	常連
hinoki	檜
###  8016 バリー
###  8017 ブリテン
bakkin	罰金
rakusei	落成
sushi	鮨
###  8021 マネー
###  8022 ヒップホップ
###  8023 ネルソン
fukusou	服装
###  8025 ケア
###  8026 ストック
fukubu	腹部
kyouyu	教諭
nikkan	日刊
totsugu	嫁ぐ
fuunyuu	封入
sado	佐渡
###  8033 カセット
onore	己
shazou	写像
## in	因	員
###  8037 ヴェルディ
## men	免	面
ikken	一見
###  8040 カルシウム
###  8041 ウォーズ
###  8042 ビュー
###  8043 スプリント
chouju	長寿
###  8045 シャープ
horyuu	保留
yudaneru	委ねる
daiyaku	代役
banzuke	番付
gakkyuu	学級
hanten	反転
###  8052 サイエンス
###  8053 レーン
shounai	庄内
kaneda	金田
kanzei	関税
## sousou	早々	曹操
## kitai	気体	機体
###  8059 リサーチ
###  8060 ヨハネス
jounetsu	情熱
## kin	斤	金
furusato	古里
tsukiau	付き合う
kangai	灌漑
## giji	疑似	議事
ooyoso	おおよそ
yuigon	遺言
###  8069 ルパン
###  8070 トヨタjidousha
###  8071 ミシェル
ayu	鮎
yuutou	優等
## koudan	公団	講談
###  8075 マルコ
## toku	溶く	徳
sokai	疎開
sekigaisen	赤外線
## kouza	口座	講座
###  8080 カリウム
## chuusei	忠誠	中世
kyouben	教鞭
tsuuyaku	通訳
kyouko	強固
###  8085 アクセント
tenran	展覧
## utau	謳う	歌う
###  8088 アトラクション
###  8089 バード
akamatsu	赤松
sunpou	寸法
kouhei	工兵
hatarakikakeru	働き掛ける
jouraku	上洛
fujimi	富士見
sanroku	山麓
## taikan	戴冠	退官
###  8098 エニックス
gunju	軍需
ikeru	生ける
## rai	癩	来
## kai	快	回
kouyou	公用
kirihanasu	切り離す
fujimoto	藤本
## tenshin	転身	天津
###  8107 ブリュッセル
honkan	本館
###  8109 ウルグアイ
###  8110 ストライキ
buraku	部落
###  8112 メチル
###  8113 アルベルト
###  8114 クリストファー
seigaku	声楽
## houshin	砲身	方針
###  8117 スーパーボウル
youchuu	幼虫
subaru	昴
sennin	専任
## tazuneru	尋ねる	訪ねる
teichi	低地
danmen	断面
jousou	上層
toridasu	取り出す
kaiki	回帰
mokuroku	目録
chinou	知能
## nomi	蚤	のみ
shaden	社殿
konketsu	混血
## eisei	永正	衛星
###  8133 スプリング
###  8134 バイオ
###  8135 パズル
yakushin	躍進
fujitsuu	富士通
###  8138 ギニア
furo	風呂
miukeru	見受ける
totoku	都督
nenpi	燃費
## nyuusen	入選	入線
###  8144 ボーン
meibo	名簿
genshu	元首
ryuudan	榴弾
matagu	跨ぐ
## kansen	観戦	感染
## suiryoku	推力	水力
###  8151 リビア
###  8152 ホルモン
###  8153 オクラホマ
shutsuji	出自
sekijuuji	赤十字
tekitou	適当
## rei	麗	例
ikkatsu	一括
akumademo	あくまでも
enpou	延宝
jousetsu	常設
fuujiru	封じる
oyakata	親方
itameru	痛める
higo	肥後
###  8166 ジオン
###  8167 アミノsan
shouritsu	勝率
###  8169 プロフィール
###  8170 アンケート
inaba	稲葉
tokkou	特攻
chokumen	直面
chuudou	中道
hachimanguu	八幡宮
###  8176 レジスター
souma	相馬
furosu	降ろす
###  8179 ボルト
dakyou	妥協
gakugei	学芸
## ishou	意匠	衣装
akeru	明ける
daida	代打
kishuu	奇襲
###  8186 ミックス
###  8187 フック
toutan	東端
senri	千里
hitteki	匹敵
haigyou	廃業
chihyou	地表
kawashima	川島
konseki	痕跡
## kani	蟹	簡易
###  8196 ボーイズ
###  8197 コロニー
###  8198 ウォルター
###  8199 ベラルーシ
rojou	路上
ririku	離陸
senchou	船長
bessatsu	別冊
douten	同点
uriba	売り場
benri	便利
takusu	託す
katsushika	葛飾
yokugetsu	翌月
gekiteki	劇的
## suikei	推計	水系
## kaihei	開閉	海兵
mahi	麻痺
###  8214 フード
###  8215 ブロードウェイ
zenken	全権
dairen	大連
###  8218 アップデート
## kyougi	教義	競技
## kou	亘	公
densou	伝送
###  8222 ミッドフィールダー
jinsoku	迅速
kataoka	片岡
chuuseishi	中性子
kyouyo	供与
## shinchou	慎重	身長
tanpo	担保
matsushima	松島
honjou	本庄
## shikyuu	四球	支給
## kokusai	国債	国際
kudara	百済
## kou	坑	公
kodama	児玉
###  8236 マニュアル
###  8237 フィクション
kettou	血統
kouitta	こういった
wana	罠
## ou	凹	王
mattan	末端
shidai	次第
genan	原案
## shinri	真理	心理
isei	異性
###  8247 ティン
## kyoukou	強硬	教皇
oogaki	大垣
oosaki	大崎
taiji	対峙
kakusan	拡散
doukyo	同居
## shisen	四川	支線
itabashi	板橋
kyuuyu	給油
###  8257 キス
###  8258 チェス
noguchi	野口
daishou	大小
hidoi	ひどい
###  8262 シール
## kinsei	金星	近世
henjou	返上
## yuushi	有志	融資
###  8266 レイク
## koushaku	侯爵	公爵
senpou	戦法
hakugai	迫害
###  8270 キャンセル
###  8271 オープンソース
aoru	煽る
## tomu	止む	富む
oosawa	大沢
###  8275 ジョーダン
## mottomo	もっとも	最も
###  8277 アイスホッケー
ezo	蝦夷
kaika	開花
shinkyuu	進級
## houshi	奉仕	胞子
###  8282 トルク
###  8283 スティーブ
## juu	充	重
## kanjou	艦上	環状
ukagaeru	伺える
kouei	公営
###  8288 クリスタル
###  8289 ウィスコンシン
## tsukuru	創る	作る
kugiru	区切る
###  8292 エリザベト
## satoshi	聡	賢
mitsumoru	見積もる
###  8295 インドhiroshi
tetsuya	哲也
kakiorosu	書き下ろす
kyuusen	休戦
## doui	同位	同意
## kiji	生地	記事
kyoyou	許容
saiji	歳時
bokoku	母国
## osaeru	押さえる	抑える
issen	一線
###  8306 カープ
bizen	備前
juugeki	銃撃
###  8309 スロット
## aka	垢	赤
danchou	団長
seshuu	世襲
tejun	手順
###  8314 ミスター
kyouretsu	強烈
ryougun	両軍
###  8317 ショウ
sandou	賛同
ochiai	落合
yonezawa	米沢
masshou	抹消
###  8322 ウェル
## dou	胴	堂
## fushi	父子	節
hedateru	隔てる
uranau	占う
## shihou	四方	司法
###  8328 サテライト
sugawara	菅原
kokuji	告示
setsugou	接合
###  8332 ライアン
nozomashii	望ましい
## jirou	治郎	次郎
###  8335 ベーシスト
###  8336 チャン
komaki	小牧
###  8338 オフィシャル
rika	理科
## choutei	調停	朝廷
###  8341 ストックホルム
###  8342 オバマ
###  8343 マリン
###  8344 ドラッグ
nagato	長門
gyokou	漁港
## jisha	寺社	自社
## kouten	公転	交点
joukamachi	城下町
denpou	電報
shuukei	集計
fukusen	複線
###  8353 タンカー
###  8354 スタンリー
kedo	けど
## saku	柵	作
###  8357 ナイフ
###  8358 ボーイ
eri	襟
hokugi	北魏
tokorozawa	所沢
hikikaeru	引き換える
###  8363 ローリング
zougo	造語
###  8365 カタルーニャ
###  8366 サブタイトル
###  8367 シェイクスピア
###  8368 ルター
datou	打倒
miko	巫女
magaru	曲がる
## take	茸	竹
samui	寒い
## josei	助成	女性
yakudatsu	役立つ
###  8376 サンパウロ
###  8377 チャージ
kumiawasu	組み合わす
kekkaku	結核
futou	埠頭
###  8381 モンテネグロ
gengou	元号
dokusei	毒性
shaberu	喋る
kanso	簡素
chuukou	中高
###  8387 メンテナンス
nyuubu	入部
misui	未遂
## kau	飼う	買う
konzai	混在
daihon	台本
gyoukaku	仰角
houka	放火
seru	競る
###  8396 ポルシェ
###  8397 ブラッド
###  8398 メーター
makuuchi	幕内
dekakeru	出掛ける
doushisha	同志社
## kouyou	紅葉	公用
tamau	給う
shakui	爵位
chouwa	調和
###  8406 アッ
## houtei	法定	法廷
mochinushi	持ち主
kaieki	改易
chouhou	諜報
katahou	片方
kawai	河合
###  8413 ロンバルディア
nawa	縄
toukaku	頭角
###  8416 パーキング
###  8417 カプセル
tsumorida	つもりだ
###  8419 キャップ
kakusei	覚醒
###  8421 レンジ
## aki	晶	秋
junkyouju	准教授
kanashimu	悲しむ
###  8425 ポートランド
juuzoku	従属
matsuoka	松岡
###  8428 ライプツィヒ
hankyou	反響
## seishoku	生殖	聖職
###  8431 モーリス
matsudo	松戸
###  8433 プファルツ
###  8434 ボスニア・ヘルツェゴビナ
###  8435 エストニア
###  8436 シールド
## kawauchi	川内	河内
## kikou	寄稿	機構
koji	故事
jiden	自伝
kuutei	空挺
youga	洋画
hondou	本堂
tsue	杖
azusa	梓
###  8446 シンセサイザー
hire	ひれ
fuudo	風土
## shishou	死傷	師匠
## higashi	干菓子	東
## kai	怪	回
teni	転移
## koutei	肯定	皇帝
jisou	自走
## sumi	隅	炭
###  8456 クルー
ase	汗
## kyouchou	協調	強調
yobina	呼び名
## saishuu	採集	最終
okamura	岡村
## kyou	峡	教
###  8463 セックス
oozei	大勢
funsha	噴射
###  8466 ディビジョン
###  8467 ウィン
###  8468 ウイング
###  8469 アテナイ
raigeki	雷撃
yakugaku	薬学
## hakkou	発光	発行
###  8473 ジャマイカ
## shishou	支障	師匠
###  8475 レーニン
###  8476 チャリティー
###  8477 パラメータ
## kiban	基板	基盤
fukkoku	復刻
shishutsu	支出
## soku	即	束
kakyuu	下級
daisansha	第三者
mugi	麦
nikkei	日経
###  8486 バッファロー
hosei	補正
inin	委任
###  8489 リリーフ
###  8490 ブラウザ
kyuuchuu	宮中
shuuzou	収蔵
kenjou	献上
hikoku	被告
## isou	移送	位相
tsuuyou	通用
ijimeru	苛める
###  8498 ハノーファー
###  8499 メルセデス
###  8500 オールド
ippouteki	一方的
dasuu	打数
###  8503 フロー
## jun	潤	順
## kanshou	環礁	干渉
nichiya	日夜
## hakkou	発酵	発行
###  8508 サイモン
## sensei	先制	先生
###  8510 ユタ
## sharyou	車輛	車両
moushitateru	申し立てる
###  8513 イニング
###  8514 パール
###  8515 リーチ
## isei	以西	異性
## teigen	提言	低減
###  8518 エリート
###  8519 オールナイトニッポン
suga	須賀
## hiku	惹く	引く
###  8522 セメント
###  8523 キッド
totonou	整う
biyoku	尾翼
###  8526 ウォーカー
kajuu	荷重
handou	反動
###  8529 マイナス
kira	吉良
sourou	候
koumeitou	公明党
kussaku	掘削
dassou	脱走
dosha	土砂
kenichi	健一
muko	婿
azukaru	預かる
najimu	馴染む
## ichiin	一因	一員
sonchou	尊重
###  8542 チーズ
## yuzuru	譲	譲る
## gensoku	減速	原則
nenshi	年始
keikyuu	京急
youhei	傭兵
###  8548 レンジャー
zenei	前衛
## kikan	器官	機関
## shuukan	収監	週間
## kadou	可動	稼働
juutou	充当
suberu	滑る
kakoku	過酷
## kouhai	交配	後輩
rekkyo	列挙
###  8558 フィッシュ
###  8559 メカニズム
###  8560 ホームラン
taijou	退場
nittere	日テレ
jakunen	弱年
kaibutsu	怪物
shohan	初版
shinsou	真相
kuse	癖
###  8568 パウロ
jakuten	弱点
yojou	余剰
kahoku	河北
mochikaeru	持ち帰る
## itou	厭う	伊藤
###  8574 リーガ
ourai	往来
konsei	混成
sougen	草原
senchuu	戦中
## kaeru	代える	変える
###  8580 ソユーズ
###  8581 スロー
## so	粗	祖
###  8583 メード
## aruiha	或いは	あるいは
kyoushuu	教習
appaku	圧迫
## senjou	線上	戦場
moushikomu	申し込む
###  8589 クレーター
gouben	合弁
hangen	半減
hisabisa	久々
## taeru	絶える	耐える
## kyo	虚	挙
## kasen	架線	河川
###  8596 フライト
###  8597 クーペ
eiyo	栄誉
meibutsu	名物
###  8600 コサック
###  8601 カップル
ritsumeikan	立命館
hau	這う
kakusa	格差
## koui	好意	行為
jissuu	実数
nigate	苦手
aso	阿蘇
tabidatsu	旅立つ
doushu	同種
shuujin	囚人
chozou	貯蔵
yuuenchi	遊園地
###  8614 アンディ
###  8615 ゴードン
## akira	あきら	昭
## me	芽	目
kachikosu	勝ち越す
bimyou	微妙
## hokan	補完	保管
mezameru	目覚める
kaimen	海面
konan	湖南
hatsuan	発案
## tatsu	絶つ	立つ
tsukasadoru	司どる
kisuu	奇数
aijin	愛人
###  8629 サラブレッド
###  8630 ファイターズ
###  8631 デニス
## hirou	拾う	披露
sokuzani	即座に
nishio	西尾
chikugo	筑後
yuujou	友情
kisu	来す
tougoku	投獄
chuushaku	注釈
## ryou	漁	量
mokuromu	目論む
sanada	真田
## rentai	連帯	連隊
###  8644 インフラ
hounou	奉納
etsu	悦
ippa	一派
## amari	あまり	余り
###  8649 ミハイル
gekisen	激戦
gouzoku	豪族
###  8652 リポーター
kusurishi	薬師
chouan	長安
kimitsu	機密
anchi	安置
sakuma	佐久間
## meiji	明示	明治
## koushi	公司	講師
hogei	捕鯨
## ja	邪	じゃ
###  8662 ソマリア
## sougyou	操業	創業
sanmei	山名
## teiki	提起	定期
## zenjitsu	全日	前日
nenpou	年俸
tagawa	田川
## shuushi	終始	修士
zetsubou	絶望
## keikou	蛍光	傾向
maou	魔王
###  8673 ソニック
masanori	正徳
## taitou	台東	台頭
kawanishi	川西
###  8677 マルタ
takao	高雄
###  8679 スレッド
###  8680 ブルックリン
one	尾根
suukikyou	枢機卿
entou	円筒
shinkai	深海
byouri	病理
###  8686 プラント
suigai	水害
## hasshin	発進	発信
chosui	貯水
habu	波布
kangengaku	管弦楽
###  8692 バックアップ
## aya	あや	綾
kokuhou	国宝
## shotou	初等	諸島
yuuyou	有用
ukagau	伺う
shinetsu	信越
###  8699 ママ
###  8700 ドラゴンボール
kaibatsu	海抜
## hiroshi	ひろし	弘
###  8703 ストレス
###  8704 プリント
## seidou	制動	聖堂
## jishin	自信	自身
shishuu	詩集
## men	麺	面
###  8709 ゲルマン
###  8710 オンタリオ
juchuu	受注
majiwaru	交わる
kandou	感動
sokusen	側線
## yousei	妖精	要請
shukusei	粛清
ikinari	いきなり
###  8718 ジョゼフ
fuhen	普遍
zaishoku	在職
matowaru	纏わる
chaya	茶屋
giketsu	議決
###  8724 ジェームス
###  8725 デイリー
## dan	断	団
nissanjidousha	日産自動車
## ateru	宛てる	当てる
banpaku	万博
## koutou	高騰	高等
hassou	発想
dokusho	読書
shousha	勝者
tata	多々
haiku	俳句
nyuushi	入試
roujuu	老中
teiban	定番
## kizoku	帰属	貴族
sugiyama	杉山
kuchibiru	唇
kowasu	壊す
yamamichi	山道
###  8744 ワード
###  8745 ファー
## mesu	目す	雌
## chiri	塵	地理
kyakka	却下
biyou	美容
zenmetsu	全滅
yae	八重
###  8752 ニュルンベルク
###  8753 スーダン
## kakou	下降	加工
###  8755 コイル
ryuudou	流動
masamune	政宗
ichiryuu	一流
###  8759 ミャンマー
hanrei	判例
###  8761 クック
katsujou	割譲
taiha	大破
dangan	弾丸
oreru	折れる
kareru	枯れる
teisen	停戦
## shisaku	施策	試作
###  8769 セクター
## futou	不当	埠頭
shinpi	神秘
takatsuki	高槻
## koga	古賀	古河
oomono	大物
jouzuru	乗ずる
## higo	庇護	肥後
## koushin	後進	更新
ichiou	一応
gosa	誤差
## touyou	登用	東洋
kakkou	恰好
taiiki	帯域
musha	武者
###  8784 ポピュラー
###  8785 グラミー
## toru	とる	取る
nakatsu	中津
## enka	演歌	塩化
tokumei	特命
hayabusa	隼
shito	使徒
adana	徒名
###  8793 パチスロ
yukkuri	ゆっくり
## kitei	基底	規定
ariake	有り明け
###  8797 スピーカー
bakushou	爆笑
mitoosu	見通す
fukuchiyama	福知山
## sanshutsu	算出	産出
## kiken	棄権	危険
bitchuu	備中
###  8804 シャーシ
###  8805 オーダー
## kakushin	確信	革新
tsudou	集う
tenten	転々
###  8809 チョコレート
hiniku	皮肉
## kougen	公言	高原
shishaku	子爵
kouryoku	効力
ouei	応永
## ninshou	人称	認証
kyuushin	急進
shuuchaku	終着
nagisa	渚
hottan	発端
###  8820 ファイター
###  8821 ゲームボーイ
tsuchiya	土屋
kyoryuu	居留
bessou	別荘
zessan	絶賛
## fu	符	府
## tougou	東郷	統合
kenzakai	県境
###  8829 ヒルズ
hade	派手
nishida	西田
suita	吹田
###  8833 クロック
###  8834 クラウン
urazukeru	裏付ける
## niru	煮る	似る
shunki	春季
mohou	模倣
dashin	打診
###  8840 メーク
karini	仮に
sakumotsu	作物
seiun	星雲
naguru	殴る
tekisei	適正
batsu	罰
## gifu	義父	岐阜
## youshi	容姿	養子
koseki	戸籍
hansou	搬送
asshou	圧勝
okunai	屋内
ganseki	岩石
bakuryou	幕僚
## tenka	点火	添加
## in	韻	員
shaka	釈迦
seibetsu	性別
mainichishinbun	毎日新聞
hoke	法華
oomaka	大まか
junkyuu	準急
bouchou	膨張
## shusshi	出仕	出資
kokutei	国定
## koubou	攻防	工房
###  8867 セルゲイ
mitanai	満たない
katayama	片山
kumichou	組長
tenkyo	転居
## kenshou	憲章	検証
###  8873 ケニア
ebisu	恵比須
furoku	付録
yodo	淀
###  8877 デイヴィス
shufu	主婦
daimeishi	代名詞
shingen	進言
tsubusu	潰す
noyama	野山
houwa	飽和
###  8884 キンnikuマン
reimei	黎明
arasuji	粗筋
## en	苑	円
eimei	英名
ouken	王権
ikoma	生駒
###  8891 カエサル
###  8892 カルロ
suuhai	崇拝
###  8894 リヨン
## mesu	召す	雌
###  8896 スカート
###  8897 クリミア
gekitotsu	激突
###  8899 ソフィア
###  8900 トリック
genga	原画
younen	幼年
kitami	北見
###  8904 サンプル
shina	支那
nekkyou	熱狂
chokuka	直下
toshishita	年下
###  8909 マヌエル
jisho	辞書
## waku	沸く	枠
shoshin	初心
gogatsu	五月
###  8914 グッド
nadakai	名高い
minka	民家
meiutsu	銘打つ
## chimei	致命	地名
###  8919 カジノ
nobita	のび太
buru	ぶる
hanga	版画
###  8923 ニュートン
masumasu	益々
eshi	絵師
koku	酷
datsuraku	脱落
fukuramu	膨らむ
###  8929 ブランデンブルク
###  8930 コンサルタント
###  8931 デビッド
fureau	触れ合う
## jisshi	実子	実施
kakusho	各所
teitai	停滞
tsuchii	土井
butsuryuu	物流
## you	用	よう
kimo	肝
mari	鞠
youfu	養父
nirin	二輪
###  8943 サスペンス
uzu	渦
araki	荒木
komoru	籠る
###  8947 ギャング
###  8948 チューリッヒ
###  8949 ナレーター
monjin	門人
chakumoku	着目
###  8952 ステンレス
###  8953 クリエイティブ
## kisha	汽車	記者
## taidan	対談	退団
shitateru	仕立てる
kokufuku	克服
yuugai	有害
hizumu	歪む
horie	堀江
## tokki	特記	突起
seitan	生誕
###  8963 テクニック
###  8964 トレーナー
kokubun	国分
kanan	河南
goi	語彙
kubota	久保田
minsei	民政
###  8970 キャッチフレーズ
###  8971 クラフト
teikan	貞観
## shimeru	締める	占める
###  8974 バレンシア
###  8975 スクエア
###  8976 カンヌ
suginami	杉並
###  8978 フランチェスコ
###  8979 サントリー
rikkyou	立教
senzai	潜在
hatsurei	発令
## shouhei	将兵	招聘
irie	入り江
###  8985 トーン
###  8986 ビジョン
## shudou	手動	主導
###  8988 ロビンソン
hisa	ひさ
## asai	浅井	浅い
###  8991 ボルチモア
###  8992 フィン
###  8993 シップ
furikaeru	振り返る
jakutai	弱体
hataseru	果たせる
futaba	双葉
tenchi	天地
oitsuku	追い付く
toudori	頭取
###  9001 ベンツ
###  9002 ペリー
###  9003 デスクトップ
sanson	山村
## ki	幾	機
kanrei	慣例
###  9007 ラスベガス
###  9008 キプロス
## yabureru	破れる	敗れる
kirei	綺麗
teisei	帝政
hagemu	励む
genten	原点
###  9014 デッド
###  9015 ポップス
nippou	日報
###  9017 イエロー
###  9018 イエズス
## shiteki	私的	指摘
neiro	音色
tonza	頓挫
mihara	三原
## kushi	串	駆使
daitan	大胆
###  9025 チャーリー
## kankou	敢行	観光
bankoku	万国
###  9028 カザフスタン
## kawa	革	川
baiten	売店
toukyoudenryoku	東京電力
###  9032 マウンテン
###  9033 ハリケーン
###  9034 ベンジャミン
## denpa	伝播	電波
hibiya	日比谷
tabemono	食物
teion	低温
gendou	原動
toriyameru	取り止める
shoudaku	承諾
###  9042 ヘア
###  9043 キャンベル
noroi	呪い
## touki	陶器	登記
etchuu	越中
###  9047 フィッシャー
taika	大火
## giin	議院	議員
yuuyo	猶予
## shinsui	浸水	進水
youhou	用法
###  9053 ディフェンダー
gai	害
teihaku	停泊
## saigo	最期	最後
###  9057 ユニーク
###  9058 ラック
okujou	屋上
## fukyou	布教	不況
iwaba	言わば
taikyoku	対局
###  9063 メモリアル
###  9064 ウォー
## shibou	志望	死亡
keimou	啓蒙
rensa	連鎖
tsuruoka	鶴岡
tentou	転倒
###  9070 クローン
ganyuu	含有
## kikou	寄港	機構
kagura	神楽
ronsha	論者
###  9075 カクテル
dainagon	大納言
uehara	上原
###  9078 モスク
## saru	申	去る
kusatsu	草津
juushoku	住職
###  9082 ショーン
kizuna	絆
###  9084 テッド
betto	別途
katakana	片仮名
satomi	里見
kiniro	金色
kanpeki	完璧
otagai	御互い
tsuruga	敦賀
shouhou	商法
bettou	別当
hokuto	北斗
shinguu	新宮
taihi	対比
###  9097 ノルディック
habamu	阻む
jiba	磁場
heisoku	閉塞
joudo	浄土
###  9102 ニーズ
###  9103 ヘルメット
ikiki	行き来
###  9105 リフト
funsuru	扮する
###  9107 ローテーション
amaru	余る
## toumei	東名	透明
###  9110 ファーム
###  9111 ダッシュ
###  9112 メルボルン
seiza	星座
honmaru	本丸
###  9115 テクノ
## engei	演芸	園芸
## ido	緯度	井戸
sanuki	讃岐
## tsukeru	着ける	付ける
## awa	粟	阿波
guusuu	偶数
amano	天野
kaidoku	解読
## nokosu	遺す	残す
sokuhou	速報
## kouji	公示	工事
suishitsu	水質
###  9128 フォト
###  9129 ベッド
## kyoui	驚異	脅威
oohara	大原
###  9132 マクドナルド
kigan	祈願
douwa	童話
seihoku	西北
## shukkou	出向	出航
yoshimura	吉村
kokumei	国名
yousou	様相
###  9140 ヨ
###  9141 スパルタ
iwaki	いわき
###  9143 スタンフォード
dairinin	代理人
hitachiseisakusho	日立製作所
shinpu	神父
fue	笛
chijin	知人
bukai	部会
###  9150 クロード
###  9151 ブンデスリーガ
###  9152 ハリス
tekkou	鉄鋼
shokuzai	食材
bureru	ぶれる
###  9156 アンソニー
###  9157 イヴァン
###  9158 イーグルス
narasu	鳴らす
###  9160 スペック
tekidan	擲弾
takoushiki	多項式
###  9163 リール
makura	枕
###  9165 ランナー
dokushin	独身
kyuukei	休憩
## shouten	賞典	商店
###  9169 ヒール
###  9170 ヘクタール
tsuutatsu	通達
zatsu	雑
toriokonau	執り行う
###  9174 サウジアラビア
senren	洗練
chie	知恵
## housou	包装	放送
###  9178 リスボン
jindou	人道
sezoku	世俗
daichou	台帳
###  9182 スクロール
###  9183 ノイズ
haien	肺炎
## takeda	竹田	武田
enjou	炎上
## saisen	再戦	再選
kegawa	毛皮
## kouhou	工法	後方
shoujun	照準
amu	編む
###  9192 フレーズ
###  9193 ボビー
kessan	決算
## ikki	一期	一気
###  9196 ベオグラード
###  9197 スポーツカー
###  9198 ヘブライgo
nagata	永田
hosu	干す
yousetsu	溶接
## ryuusei	流星	隆盛
rusu	留守
###  9204 クライマックス
dakkai	奪回
rekka	劣化
itten	一転
## kyousan	協賛	共産
sanbutsu	産物
###  9210 ファイア
###  9211 ブラン
rounin	浪人
houdai	邦題
muchi	鞭
joen	助演
hansei	反省
mikan	未完
mitsubishidenki	三菱電機
shissei	執政
## moji	門司	文字
nakayoshi	仲良し
saitan	最短
###  9223 セクション
## kyuusei	急逝	旧制
## hirou	疲労	披露
nishiyama	西山
touron	討論
###  9228 アームストロング
## kekkan	欠陥	血管
## shiku	市区	敷く
naihou	内包
## kashou	仮称	歌唱
###  9233 グレン
###  9234 マルク
###  9235 ブダペスト
## sensen	宣戦	戦線
orimono	織物
## manshuu	満洲	満州
###  9239 エンジェル
masuda	増田
kakujuu	拡充
###  9242 モリス
dasen	打線
shinchiku	新築
jisoku	時速
## shouchou	省庁	象徴
yourou	養老
###  9248 ケルト
###  9249 キャサリン
###  9250 アニメーター
tatoe	たとえ
joushiki	常識
## kinkou	均衡	近郊
yuugekishu	遊撃手
## atsui	熱い	厚い
###  9256 アーノルド
nezuyoi	根強い
gaisetsu	概説
tabikasanaru	度重なる
sokuryoku	速力
## shuu	臭	州
###  9262 プロトタイプ
###  9263 ナイジェリア
himen	罷免
bashu	馬主
menkai	面会
sukima	隙間
###  9268 ピース
###  9269 ブレーブス
###  9270 キャロル
## sousha	走者	奏者
odayaka	穏やか
wakasa	若狭
teate	手当て
###  9275 レンジャーズ
###  9276 ボーリング
shimon	諮問
###  9278 サターン
## kaisou	回送	改装
koisuru	恋する
goyou	御用
###  9282 シンシナティ
tto	っと
shinseki	親戚
hikkosu	引っ越す
numata	沼田
isogu	急ぐ
###  9288 レコーダー
mochi	餅
oidasu	追い出す
kawase	為替
bijo	美女
kyoukasu	脅かす
souitta	そういった
###  9295 ゴート
###  9296 フランコ
koumei	校名
kitamura	北村
jizou	地蔵
zanpai	惨敗
ijuuin	伊集院
###  9302 カーター
tasu	足す
taikyo	退去
gion	祇園
kuuhaku	空白
## seidou	青銅	聖堂
## kanchou	官庁	艦長
kenzen	健全
bunmyaku	文脈
## suiyou	水溶	水曜
kokkou	国交
###  9313 ランス
###  9314 ロビー
amako	尼子
onsetsu	音節
gunmu	軍務
###  9318 イスタンブル
tensen	転戦
rensou	連想
shouyu	醤油
###  9322 マカオ
###  9323 ドキュメント
## koutou	江東	高等
## taihi	待避	対比
kiiroi	黄色い
hensai	返済
takenaka	竹中
kumikyoku	組曲
###  9330 マニア
###  9331 ティム
###  9332 アダムズ
###  9333 インク
###  9334 ストン
###  9335 ミッドウェー
yayu	揶揄
sadamaru	定まる
takauji	尊氏
konishi	小西
###  9340 シッカリ
dame	駄目
###  9342 ニコラ
zoufuku	増幅
## gakki	学期	楽器
suigin	水銀
kazusa	上総
naruto	鳴門
machigaeru	間違える
kaerizaku	返り咲く
###  9350 アルフォンソ
goumon	拷問
numazu	沼津
taiboku	大木
###  9354 ステュアート
yuzuriukeru	譲り受ける
uriagedaka	売上高
zenshou	全勝
###  9358 ヴァル
###  9359 スライダー
## kaji	火事	舵
hanazono	花園
makanau	賄う
###  9363 レッスン
shijitsu	史実
kessai	決済
bokou	母校
###  9367 ピラミッド
###  9368 ヒント
shajiku	車軸
shoukan	召喚
yuurei	幽霊
hirayama	平山
midareru	乱れる
###  9374 レイカーズ
daisuki	大好き
yuusha	勇者
###  9377 クリエイター
## keishou	景勝	継承
kaizoudo	解像度
## houdai	砲台	邦題
## awa	泡	阿波
## tsuru	蔓	鶴
###  9383 ジェーン
torikakomu	取り囲む
iya	嫌
juujika	十字架
genyu	原油
## doushi	同志	動詞
## kouhan	広範	後半
honkou	本校
kaizuka	貝塚
kakugi	閣議
###  9393 ジャガー
###  9394 コンポーネント
## taii	退位	大尉
renkou	連行
sosuu	素数
## taisei	耐性	体制
kabuka	株価
oohira	大平
###  9401 アワード
###  9402 カスタム
tosshutsu	突出
girei	儀礼
## kougai	公害	郊外
## kyoudai	強大	兄弟
###  9407 ヘヴィ
jigai	自害
unnan	雲南
## shinsei	新星	申請
###  9411 ロマンス
tengu	天狗
## kika	帰化	幾何
maiji	毎時
###  9415 クレイ
###  9416 マスターズ
###  9417 スローガン
###  9418 ニール
###  9419 ハイウェイ
###  9420 ポニーキャニオン
son	損
seku	急く
hashigami	橋上
shutaru	主たる
sakusan	酢酸
tsutsui	筒井
happou	発砲
ada	仇
shiina	椎名
## shiru	汁	知る
shinei	新鋭
danin	団員
kuwana	桑名
tsuide	次いで
## datou	妥当	打倒
###  9436 テンポ
###  9437 ベータ
hekiga	壁画
shimamura	島村
kyoumei	共鳴
oshidasu	押し出す
gekisakka	劇作家
###  9443 スリランカ
###  9444 ブリティッシュ
tenshu	天守
## shousha	照射	勝者
bussan	物産
ohayou	おはよう
botsuraku	没落
###  9450 タイガー
###  9451 マルティン
choushuuhan	長州藩
nae	苗
gyuunyuu	牛乳
## hontou	本島	本当
tatoeru	例える
###  9457 センス
kannen	観念
nouen	農園
koukuri	高句麗
###  9461 クレru
yao	八尾
###  9463 バナナ
seichuu	成虫
kaikai	開会
kinzuru	禁ずる
## sakura	佐倉	桜
sukoshizutsu	少しずつ
###  9469 ペーパー
isshou	一生
hangyaku	反逆
## ihou	移封	違法
## shourei	省令	奨励
untenshu	運転手
tehai	手配
saguru	探る
###  9477 ジャワ
###  9478 コンチネンタル
gouu	豪雨
machinami	町並み
## shuuki	秋季	周期
## jitai	字体	事態
genkoku	原告
###  9484 リンパ
## kyoukou	強行	教皇
getsumen	月面
ifuku	衣服
## yomu	詠む	読む
dokusou	独奏
gashitsu	画質
###  9491 レパートリー
###  9492 ロータス
kyuushiki	旧式
teisoku	低速
tomodomo	共々
shousoku	消息
souba	相場
## kou	考	公
muda	無駄
###  9500 ローマji
## kirai	嫌い	機雷
yamakawa	山川
daigiin	代議員
fuhai	腐敗
ryuutai	流体
###  9506 パーカー
###  9507 マフィア
yodogawa	淀川
## fuka	孵化	付加
kyuumei	救命
###  9511 プエルトリコ
###  9512 アレクサンドリア
###  9513 ジョヴァンニ
oyogu	泳ぐ
yuuboku	遊牧
###  9516 ハイデルベルク
kikyuu	気球
###  9518 エーカー
###  9519 コンパイラ
kinbou	近傍
nankou	難航
###  9522 リッチ
taimen	対面
koike	小池
iwata	岩田
###  9526 バラード
shinshuu	真宗
seigan	請願
###  9529 ネジ
namiki	並木
meisaku	名作
###  9532 コンピレーション
hideki	秀樹
enfun	円墳
jittei	実弟
## wa	わ	和
kyoubu	胸部
meigara	銘柄
gunbi	軍備
###  9540 ブルゴーニュ
kikyou	帰郷
jisshuu	実習
## taiseki	体積	堆積
## sunawachi	即ち	すなわち
## heikou	平衡	並行
kaijin	怪人
mojidoori	文字通り
###  9548 レッズ
kamisama	神様
## haisen	配線	敗戦
jukou	受講
###  9552 トロフィー
###  9553 ドレスデン
###  9554 フィリップス
yokushuu	翌週
###  9556 アース
tawara	俵
nyorai	如来
sayuusuru	左右する
seisai	制裁
hikinuku	引き抜く
shinchuu	進駐
majiru	混じる
shirai	白井
itan	異端
byougen	病原
hyoujou	表情
ichihara	市原
nakanishi	中西
## kaeru	蛙	変える
akutagawa	芥川
zousho	蔵書
fujioka	藤岡
## tentou	店頭	転倒
kyuuyaku	旧約
shikkaku	失格
###  9577 ジョッキー
###  9578 キングレコード
###  9579 コック
kyouhaku	脅迫
###  9581 ゾイド
## yagi	山羊	八木
kikyaku	棄却
kando	感度
kume	久米
hansuru	反する
tsukaiwakeru	使い分ける
enso	塩素
###  9589 コーン
kyuukyoku	究極
kaimono	買い物
kakkiteki	画期的
kaien	開園
###  9594 モーガン
younin	容認
sensai	戦災
komaru	困る
matsumae	松前
sekidou	赤道
###  9600 マキノ
hinpatsu	頻発
kanryaku	簡略
## tentou	点灯	転倒
## kousha	降車	後者
kyokugen	極限
###  9606 レッドソックス
hirai	飛来
onsoku	音速
shoumou	消耗
saibu	細部
oonishi	大西
kibun	気分
oshisusumeru	推し進める
###  9614 プラズマ
## seigan	西岸	請願
kouzuru	講ずる
omoeru	思える
###  9618 モノレール
## kansou	完走	乾燥
tsuchiura	土浦
kuyou	供養
## youshou	要衝	幼少
###  9623 サザン
###  9624 エラー
###  9625 アコースティック
fukagawa	深川
kurokawa	黒川
###  9628 tennenガス
## minoru	実る	稔
miwa	三輪
###  9631 ウォルト
joushi	上司
## mei	姪	名
senyuu	占有
## kaijou	開場	会場
rakujou	落城
kosu	越す
###  9638 フットサル
yukio	由紀夫
###  9640 クリップ
tourai	到来
goten	御殿
shinsha	新車
shinjou	新庄
uri	瓜
###  9646 アンダー
## hankou	反抗	犯行
denrai	伝来
## toki	土岐	時
nobe	延べ
###  9651 ハイパー
###  9652 ミュージアム
iwakura	岩倉
###  9654 クレーン
mayu	眉
## kikin	飢饉	基金
## koi	鯉	恋
muroran	室蘭
rekkyou	列強
yuden	油田
###  9661 ガリア
giri	義理
## ibaraki	茨木	茨城
dajoukan	太政官
###  9665 レター
## dan	壇	団
kakuzuke	格付け
###  9668 タイトルマッチ
###  9669 ブルボン
## moyori	最寄	最寄り
eikou	栄光
kyuugyou	休業
hadou	波動
mukei	無形
## teru	照る	輝
emono	獲物
bangai	番外
## kama	鎌	窯
yoroi	鎧
###  9680 グアム
## taira	平ら	平
douchou	同調
yamayama	山々
itadaku	頂く
kikka	菊花
## shounin	証人	承認
###  9687 ジュネーヴ
###  9688 アッシリア
udon	うどん
shissou	失踪
## shigai	市外	市街
juryou	受領
###  9693 リタイア
genron	言論
## keiryou	計量	軽量
kinri	金利
bo	簿
## kikou	紀行	機構
###  9699 ロープ
## kan	寒	間
## shuuha	宗派	周波
kodaira	小平
fukaketsu	不可欠
senseki	戦績
###  9705 サイレント
###  9706 チャーチル
## tenkou	転校	転向
taniguchi	谷口
youeki	溶液
###  9710 クロム
iwaya	岩屋
gongen	権現
shinobu	偲ぶ
reitou	冷凍
horikawa	堀川
###  9716 コンビニエンス
kessha	結社
###  9718 ハンセン
###  9719 ニコラス
###  9720 モナコ
moutakutou	毛沢東
## kokka	国歌	国家
## hakkou	発効	発行
## youkai	溶解	妖怪
nandemo	何でも
kowareru	壊れる
###  9727 ルーシ
busho	部署
## kenshou	顕彰	検証
moraeru	貰える
kanpuu	完封
gouin	強引
###  9733 ケープ
## gan	巌	癌
gesha	下車
atsugi	厚木
###  9737 テーマソング
mikakeru	見掛ける
hisha	飛車
###  9740 ラフ
###  9741 オーク
###  9742 ディオ
## shiga	志賀	滋賀
shikiru	仕切る
## seni	遷移	繊維
sekihi	石碑
seigo	生後
###  9748 ジェイソン
###  9749 スキャンダル
###  9750 ケント
## kan	完	間
hiratsuka	平塚
###  9753 マクラーレン
## shikai	視界	司会
teppou	鉄砲
## seisei	精製	生成
## shisei	市政	姿勢
###  9758 ライス
suizoku	水族
kokushi	国史
kokubunji	国分寺
shimoda	下田
fuchaku	付着
kiteru	企てる
shimabara	島原
###  9766 ロッド
###  9767 エコ
###  9768 バスク
baishun	売春
hahen	破片
sounan	遭難
## kokuji	酷似	告示
takasago	高砂
daiichininsha	第一人者
roppongi	六本木
###  9776 アルカリ
###  9777 アレクサンドロス
chouka	超過
###  9779 エスカレーター
guu	偶
## kanjou	勘定	環状
oroshiuri	卸し売り
naiya	内野
yabu	藪
###  9785 アラゴン
###  9786 アルブレヒト
iwakuni	岩国
kuwata	桑田
###  9789 ネーデルラント
###  9790 メモ
###  9791 ドナウ
###  9792 リバー
kateru	勝てる
shimajima	島々
nukedasu	抜け出す
###  9796 ラオス
## shinshuu	信州	真宗
myoujin	明神
honban	本番
oodoori	大通り
karatsu	唐津
###  9802 ノルマンディー
###  9803 フェリペ
nissuu	日数
sahodo	さほど
## kaikou	開口	開校
## hachi	鉢	蜂
###  9808 デラウェア
###  9809 インターハイ
###  9810 システムズ
###  9811 バファローズ
###  9812 ディック
## sennin	選任	専任
amami	奄美
shitsunaigaku	室内楽
###  9816 コペンハーゲン
gamou	蒲生
zeijaku	脆弱
sekitsui	脊椎
## kanri	官吏	管理
shutsugan	出願
kinitsu	均一
###  9823 リモコン
shishin	指針
matsubi	末尾
###  9826 リヴァプール
okiai	沖合
ryoumen	両面
mayou	迷う
###  9830 ビジュアル
chokugeki	直撃
ishinomaki	石巻
###  9833 セルティックス
## noboru	昇る	上る
shouhai	勝敗
zenrin	前輪
###  9837 モダン
kenpei	憲兵
bodai	菩提
chouyou	重用
###  9841 ニッケル
torimaku	取り巻く
haisou	敗走
###  9844 スープ
###  9845 ヘルシンキ
roudoku	朗読
funshutsu	噴出
## shuu	囚	州
shiharai	支払
jinriki	人力
hina	雛
## seihou	製法	西方
sokushitsu	側室
gisou	偽装
boshinsensou	戊辰戦争
###  9856 ポータブル
###  9857 カイロ
tsuurei	通例
oume	青梅
youshoku	養殖
###  9861 インフルエンザ
###  9862 コンコース
###  9863 カメラマン
zenpen	全編
kokon	古今
suiraitei	水雷艇
## nendo	粘土	年度
shokuba	職場
kurushii	苦しい
tenpu	添付
kirin	きりん
###  9872 プリンストン
okabe	岡部
kunrin	君臨
miso	味噌
kanpaku	関白
## hou	訪	法
## kyuumei	旧名	救命
sata	沙汰
## kaisen	会戦	海戦
juuden	充電
###  9882 ウェイン
chinza	鎮座
## kasai	葛西	火災
shuku	祝
shinpou	新報
miyagawa	宮川
sasshin	刷新
sanpo	散歩
same	鮫
oritatamu	折り畳む
###  9892 フランチャイズ
shuushin	終身
kyuufu	給付
marude	まるで
uketsuke	受付
kongen	根源
kakufuku	拡幅
## kousoku	梗塞	高速
shoukyoku	消極
###  9901 ヒスパニック
###  9902 ハンドボール
###  9903 ネバダ
kamikawa	上川
tentoumushi	てんとう虫
toyooka	豊岡
arida	有田
nichidai	日大
###  9909 ジーン
## mo	藻	喪
## shibu	渋	支部
enmoku	演目
choudai	長大
bunkyou	文京
aen	亜鉛
jitou	地頭
shodou	書道
boshi	母子
shizumeru	沈める
konoyo	此世
aoshima	青島
mitame	見た目
mizuho	みずほ
###  9924 キーパー
###  9925 サラリーマン
norikoeru	乗り越える
ikuraka	幾らか
yubiwa	指輪
shiyuu	雌雄
saidan	祭壇
naichi	内地
## kamei	亀井	加盟
## agaru	挙がる	上がる
###  9934 ニューメキシコ
naoto	直人
## ikeru	行ける	生ける
chishi	致死
itazura	悪戯
saisan	採算
uno	宇野
###  9941 フェイス
###  9942 マクシミリアン
###  9943 ミルク
###  9944 ハイチ
ganmen	顔面
## sasu	点す	指す
rigakubu	理学部
hipparu	引っ張る
## kourei	恒例	高齢
nyuukaku	入閣
osananajimi	幼馴染み
nengan	念願
haguruma	歯車
saishi	祭祀
###  9955 ベア
###  9956 アーカンソー
###  9957 ヤクザ
miboujin	未亡人
###  9959 ピョートル
###  9960 ショパン
###  9961 ガブリエル
rindou	林道
sawada	沢田
kyakusen	客船
kaikin	解禁
azabu	麻布
yuukan	夕刊
sattou	殺到
###  9969 ロイド
###  9970 クリー
###  9971 コンサルティング
###  9972 ステア
aisuru	愛する
## jushou	授賞	受賞
## teisei	訂正	帝政
###  9976 マザー
###  9977 ムーン
